Roll No,cat 1,cat 2,cat 3,overall,conversion,Result
1,39,13,18,70,46,slow leaners
2,14,40,43,97,64,Average learners
3,32,25,17,74,49,slow leaners
4,21,24,43,88,58,Average learners
5,36,24,40,100,66,Average learners
6,24,45,18,87,58,Average learners
7,31,46,27,104,69,Average learners
8,45,12,44,101,67,Average learners
9,24,46,15,85,56,Average learners
10,32,19,28,79,52,Average learners
11,36,20,24,80,53,Average learners
12,13,49,29,91,60,Average learners
13,16,18,19,53,35,slow leaners
14,43,47,18,108,72,fast learners
15,49,31,37,117,78,fast learners
16,37,23,38,98,65,Average learners
17,22,13,33,68,45,slow leaners
18,41,49,39,129,86,fast learners
19,25,48,21,94,62,Average learners
20,38,19,33,90,60,Average learners
21,33,46,39,118,78,fast learners
22,37,13,41,91,60,Average learners
23,26,12,23,61,40,slow leaners
24,25,32,16,73,48,slow leaners
25,28,47,25,100,66,Average learners
26,38,47,32,117,78,fast learners
27,40,15,47,102,68,Average learners
28,37,10,22,69,46,slow leaners
29,45,11,18,74,49,slow leaners
30,14,38,26,78,52,Average learners
31,29,46,18,93,62,Average learners
32,45,43,24,112,74,fast learners
33,30,49,15,94,62,Average learners
34,30,36,27,93,62,Average learners
35,26,39,28,93,62,Average learners
36,47,42,13,102,68,Average learners
37,41,42,23,106,70,fast learners
38,31,20,44,95,63,Average learners
39,12,33,11,56,37,slow leaners
40,42,34,12,88,58,Average learners
41,32,39,19,90,60,Average learners
42,41,21,47,109,72,fast learners
43,24,36,22,82,54,Average learners
44,27,48,21,96,64,Average learners
45,33,22,12,67,44,slow leaners
46,35,28,19,82,54,Average learners
47,17,15,43,75,50,Average learners
48,22,47,22,91,60,Average learners
49,29,26,30,85,56,Average learners
50,36,37,22,95,63,Average learners
51,30,14,37,81,54,Average learners
52,47,14,26,87,58,Average learners
53,30,17,39,86,57,Average learners
54,19,26,44,89,59,Average learners
55,21,11,43,75,50,Average learners
56,36,12,26,74,49,slow leaners
57,47,23,21,91,60,Average learners
58,48,19,20,87,58,Average learners
59,11,42,49,102,68,Average learners
60,26,44,22,92,61,Average learners
61,31,28,30,89,59,Average learners
62,18,13,13,44,29,slow leaners
63,48,16,14,78,52,Average learners
64,22,17,44,83,55,Average learners
65,46,41,11,98,65,Average learners
66,44,16,26,86,57,Average learners
67,16,22,15,53,35,slow leaners
68,31,49,20,100,66,Average learners
69,43,34,47,124,82,fast learners
70,48,43,28,119,79,fast learners
71,13,12,10,35,23,slow leaners
72,28,40,46,114,76,fast learners
73,28,44,28,100,66,Average learners
74,46,38,46,130,86,fast learners
75,27,23,49,99,66,Average learners
76,18,29,11,58,38,slow leaners
77,17,39,16,72,48,slow leaners
78,23,14,43,80,53,Average learners
79,37,25,34,96,64,Average learners
80,21,37,49,107,71,fast learners
81,11,28,28,67,44,slow leaners
82,11,33,15,59,39,slow leaners
83,13,16,44,73,48,slow leaners
84,31,33,11,75,50,Average learners
85,39,18,39,96,64,Average learners
86,10,12,12,34,22,slow leaners
87,11,24,34,69,46,slow leaners
88,13,17,39,69,46,slow leaners
89,47,47,27,121,80,fast learners
90,11,41,32,84,56,Average learners
91,19,35,24,78,52,Average learners
92,47,39,40,126,84,fast learners
93,37,15,20,72,48,slow leaners
94,18,18,21,57,38,slow leaners
95,27,37,41,105,70,fast learners
96,41,46,39,126,84,fast learners
97,22,13,10,45,30,slow leaners
98,42,29,11,82,54,Average learners
99,19,28,23,70,46,slow leaners
100,43,29,34,106,70,fast learners
101,36,36,17,89,59,Average learners
102,28,28,33,89,59,Average learners
103,42,49,34,125,83,fast learners
104,42,47,44,133,88,fast learners
105,31,26,24,81,54,Average learners
106,29,48,14,91,60,Average learners
107,45,11,43,99,66,Average learners
108,23,36,21,80,53,Average learners
109,38,11,28,77,51,Average learners
110,10,27,41,78,52,Average learners
111,15,23,46,84,56,Average learners
112,30,38,46,114,76,fast learners
113,40,37,27,104,69,Average learners
114,37,22,26,85,56,Average learners
115,25,40,41,106,70,fast learners
116,23,28,43,94,62,Average learners
117,31,23,38,92,61,Average learners
118,29,13,24,66,44,slow leaners
119,12,18,38,68,45,slow leaners
120,39,18,10,67,44,slow leaners
121,39,30,41,110,73,fast learners
122,12,47,27,86,57,Average learners
123,42,42,32,116,77,fast learners
124,14,12,23,49,32,slow leaners
125,25,27,19,71,47,slow leaners
126,38,26,33,97,64,Average learners
127,15,30,26,71,47,slow leaners
128,12,15,48,75,50,Average learners
129,25,32,41,98,65,Average learners
130,15,47,18,80,53,Average learners
131,33,27,15,75,50,Average learners
132,10,32,43,85,56,Average learners
133,43,41,42,126,84,fast learners
134,21,32,48,101,67,Average learners
135,32,49,22,103,68,Average learners
136,44,12,23,79,52,Average learners
137,20,32,39,91,60,Average learners
138,18,10,26,54,36,slow leaners
139,33,16,40,89,59,Average learners
140,49,37,41,127,84,fast learners
141,37,47,48,132,88,fast learners
142,34,21,27,82,54,Average learners
143,33,11,26,70,46,slow leaners
144,23,21,10,54,36,slow leaners
145,48,44,24,116,77,fast learners
146,40,40,37,117,78,fast learners
147,38,20,11,69,46,slow leaners
148,38,24,40,102,68,Average learners
149,11,47,14,72,48,slow leaners
150,20,16,30,66,44,slow leaners
151,45,46,41,132,88,fast learners
152,11,29,48,88,58,Average learners
153,27,43,43,113,75,fast learners
154,23,27,48,98,65,Average learners
155,31,40,27,98,65,Average learners
156,47,30,11,88,58,Average learners
157,27,28,35,90,60,Average learners
158,30,12,17,59,39,slow leaners
159,44,43,27,114,76,fast learners
160,24,42,23,89,59,Average learners
161,22,34,18,74,49,slow leaners
162,11,49,35,95,63,Average learners
163,27,24,10,61,40,slow leaners
164,42,36,23,101,67,Average learners
165,31,17,39,87,58,Average learners
166,14,42,30,86,57,Average learners
167,41,20,38,99,66,Average learners
168,31,28,41,100,66,Average learners
169,49,17,32,98,65,Average learners
170,21,17,32,70,46,slow leaners
171,10,44,21,75,50,Average learners
172,26,25,14,65,43,slow leaners
173,46,23,22,91,60,Average learners
174,46,35,18,99,66,Average learners
175,30,46,20,96,64,Average learners
176,16,17,19,52,34,slow leaners
177,14,31,49,94,62,Average learners
178,14,37,18,69,46,slow leaners
179,19,27,48,94,62,Average learners
180,14,18,48,80,53,Average learners
181,43,17,42,102,68,Average learners
182,29,39,47,115,76,fast learners
183,38,10,20,68,45,slow leaners
184,34,34,16,84,56,Average learners
185,34,17,33,84,56,Average learners
186,35,45,48,128,85,fast learners
187,48,33,30,111,74,fast learners
188,15,37,21,73,48,slow leaners
189,36,22,19,77,51,Average learners
190,40,38,27,105,70,fast learners
191,38,30,34,102,68,Average learners
192,18,22,22,62,41,slow leaners
193,44,31,20,95,63,Average learners
194,39,48,31,118,78,fast learners
195,10,49,24,83,55,Average learners
196,38,28,21,87,58,Average learners
197,32,23,30,85,56,Average learners
198,30,42,38,110,73,fast learners
199,11,10,24,45,30,slow leaners
200,26,15,13,54,36,slow leaners
201,16,14,12,42,28,slow leaners
202,22,44,35,101,67,Average learners
203,45,24,25,94,62,Average learners
204,32,16,20,68,45,slow leaners
205,27,33,47,107,71,fast learners
206,22,14,12,48,32,slow leaners
207,29,35,41,105,70,fast learners
208,41,41,42,124,82,fast learners
209,31,13,15,59,39,slow leaners
210,10,30,44,84,56,Average learners
211,36,49,39,124,82,fast learners
212,26,40,18,84,56,Average learners
213,16,39,48,103,68,Average learners
214,49,36,23,108,72,fast learners
215,27,39,13,79,52,Average learners
216,15,36,17,68,45,slow leaners
217,48,42,14,104,69,Average learners
218,12,49,29,90,60,Average learners
219,33,24,35,92,61,Average learners
220,35,33,25,93,62,Average learners
221,46,41,14,101,67,Average learners
222,15,21,33,69,46,slow leaners
223,28,31,13,72,48,slow leaners
224,14,34,47,95,63,Average learners
225,34,47,12,93,62,Average learners
226,28,42,32,102,68,Average learners
227,38,44,47,129,86,fast learners
228,11,49,45,105,70,fast learners
229,30,29,25,84,56,Average learners
230,49,35,43,127,84,fast learners
231,28,24,12,64,42,slow leaners
232,10,26,45,81,54,Average learners
233,11,37,14,62,41,slow leaners
234,27,33,38,98,65,Average learners
235,19,31,11,61,40,slow leaners
236,10,43,25,78,52,Average learners
237,44,18,16,78,52,Average learners
238,20,43,49,112,74,fast learners
239,27,11,37,75,50,Average learners
240,46,30,49,125,83,fast learners
241,10,38,11,59,39,slow leaners
242,45,19,47,111,74,fast learners
243,40,38,44,122,81,fast learners
244,33,40,34,107,71,fast learners
245,44,13,48,105,70,fast learners
246,44,30,32,106,70,fast learners
247,47,40,33,120,80,fast learners
248,38,11,34,83,55,Average learners
249,17,43,39,99,66,Average learners
250,13,21,19,53,35,slow leaners
251,32,40,36,108,72,fast learners
252,40,35,10,85,56,Average learners
253,39,41,11,91,60,Average learners
254,19,25,49,93,62,Average learners
255,30,37,21,88,58,Average learners
256,39,40,25,104,69,Average learners
257,32,47,27,106,70,fast learners
258,47,44,19,110,73,fast learners
259,27,40,17,84,56,Average learners
260,30,46,49,125,83,fast learners
261,22,20,15,57,38,slow leaners
262,28,20,32,80,53,Average learners
263,46,33,33,112,74,fast learners
264,30,38,26,94,62,Average learners
265,44,21,41,106,70,fast learners
266,43,46,33,122,81,fast learners
267,43,33,16,92,61,Average learners
268,43,46,32,121,80,fast learners
269,23,31,10,64,42,slow leaners
270,44,43,21,108,72,fast learners
271,31,24,23,78,52,Average learners
272,26,26,21,73,48,slow leaners
273,49,25,18,92,61,Average learners
274,46,24,30,100,66,Average learners
275,32,26,46,104,69,Average learners
276,13,19,24,56,37,slow leaners
277,29,28,36,93,62,Average learners
278,17,46,12,75,50,Average learners
279,12,19,32,63,42,slow leaners
280,31,12,15,58,38,slow leaners
281,12,35,16,63,42,slow leaners
282,27,28,11,66,44,slow leaners
283,14,39,35,88,58,Average learners
284,41,20,15,76,50,Average learners
285,17,36,36,89,59,Average learners
286,13,46,28,87,58,Average learners
287,13,36,13,62,41,slow leaners
288,25,10,28,63,42,slow leaners
289,34,25,13,72,48,slow leaners
290,45,23,16,84,56,Average learners
291,33,26,49,108,72,fast learners
292,39,44,23,106,70,fast learners
293,16,24,12,52,34,slow leaners
294,44,45,28,117,78,fast learners
295,46,11,34,91,60,Average learners
296,49,28,21,98,65,Average learners
297,19,30,10,59,39,slow leaners
298,29,47,36,112,74,fast learners
299,11,26,27,64,42,slow leaners
300,15,41,28,84,56,Average learners
301,33,30,22,85,56,Average learners
302,16,27,11,54,36,slow leaners
303,45,29,15,89,59,Average learners
304,17,35,17,69,46,slow leaners
305,39,43,39,121,80,fast learners
306,37,18,47,102,68,Average learners
307,47,31,48,126,84,fast learners
308,23,34,22,79,52,Average learners
309,36,30,16,82,54,Average learners
310,25,36,48,109,72,fast learners
311,13,12,38,63,42,slow leaners
312,12,24,21,57,38,slow leaners
313,27,46,48,121,80,fast learners
314,49,49,44,142,94,fast learners
315,38,22,25,85,56,Average learners
316,43,14,31,88,58,Average learners
317,12,37,16,65,43,slow leaners
318,42,26,24,92,61,Average learners
319,47,47,45,139,92,fast learners
320,27,44,21,92,61,Average learners
321,35,19,38,92,61,Average learners
322,16,13,18,47,31,slow leaners
323,16,14,16,46,30,slow leaners
324,26,31,21,78,52,Average learners
325,18,45,14,77,51,Average learners
326,25,11,29,65,43,slow leaners
327,48,27,10,85,56,Average learners
328,40,45,44,129,86,fast learners
329,40,25,43,108,72,fast learners
330,29,31,45,105,70,fast learners
331,17,39,31,87,58,Average learners
332,19,44,19,82,54,Average learners
333,35,27,25,87,58,Average learners
334,42,39,45,126,84,fast learners
335,14,47,24,85,56,Average learners
336,40,43,44,127,84,fast learners
337,39,25,38,102,68,Average learners
338,41,13,40,94,62,Average learners
339,23,12,44,79,52,Average learners
340,10,15,11,36,24,slow leaners
341,31,28,44,103,68,Average learners
342,19,43,28,90,60,Average learners
343,12,45,17,74,49,slow leaners
344,21,17,39,77,51,Average learners
345,28,32,30,90,60,Average learners
346,11,39,40,90,60,Average learners
347,15,40,32,87,58,Average learners
348,10,19,38,67,44,slow leaners
349,12,38,33,83,55,Average learners
350,35,49,14,98,65,Average learners
351,17,16,43,76,50,Average learners
352,32,47,37,116,77,fast learners
353,19,21,18,58,38,slow leaners
354,23,47,16,86,57,Average learners
355,38,16,41,95,63,Average learners
356,37,27,29,93,62,Average learners
357,41,38,12,91,60,Average learners
358,16,29,16,61,40,slow leaners
359,10,48,20,78,52,Average learners
360,19,33,36,88,58,Average learners
361,31,29,20,80,53,Average learners
362,29,46,35,110,73,fast learners
363,20,12,15,47,31,slow leaners
364,17,42,19,78,52,Average learners
365,41,49,24,114,76,fast learners
366,16,11,12,39,26,slow leaners
367,13,19,32,64,42,slow leaners
368,27,44,43,114,76,fast learners
369,40,11,11,62,41,slow leaners
370,13,49,35,97,64,Average learners
371,26,37,22,85,56,Average learners
372,20,25,20,65,43,slow leaners
373,39,17,48,104,69,Average learners
374,35,12,42,89,59,Average learners
375,18,30,40,88,58,Average learners
376,32,24,26,82,54,Average learners
377,36,35,34,105,70,fast learners
378,24,43,33,100,66,Average learners
379,48,47,30,125,83,fast learners
380,39,26,27,92,61,Average learners
381,38,36,27,101,67,Average learners
382,33,46,20,99,66,Average learners
383,36,36,49,121,80,fast learners
384,26,11,13,50,33,slow leaners
385,41,45,38,124,82,fast learners
386,29,32,34,95,63,Average learners
387,49,20,37,106,70,fast learners
388,10,14,11,35,23,slow leaners
389,49,40,46,135,90,fast learners
390,30,10,15,55,36,slow leaners
391,27,30,35,92,61,Average learners
392,44,23,37,104,69,Average learners
393,18,20,17,55,36,slow leaners
394,40,44,43,127,84,fast learners
395,16,47,15,78,52,Average learners
396,34,36,42,112,74,fast learners
397,23,38,49,110,73,fast learners
398,28,42,28,98,65,Average learners
399,27,38,11,76,50,Average learners
400,17,21,16,54,36,slow leaners
401,45,46,23,114,76,fast learners
402,36,19,23,78,52,Average learners
403,24,11,31,66,44,slow leaners
404,19,36,15,70,46,slow leaners
405,45,46,43,134,89,fast learners
406,28,45,48,121,80,fast learners
407,26,41,33,100,66,Average learners
408,22,35,18,75,50,Average learners
409,33,36,24,93,62,Average learners
410,19,12,17,48,32,slow leaners
411,20,24,38,82,54,Average learners
412,12,20,31,63,42,slow leaners
413,38,21,34,93,62,Average learners
414,20,27,38,85,56,Average learners
415,26,34,10,70,46,slow leaners
416,14,30,23,67,44,slow leaners
417,33,48,27,108,72,fast learners
418,30,37,28,95,63,Average learners
419,42,20,19,81,54,Average learners
420,23,20,47,90,60,Average learners
421,48,23,39,110,73,fast learners
422,48,32,12,92,61,Average learners
423,40,32,15,87,58,Average learners
424,41,39,16,96,64,Average learners
425,27,42,49,118,78,fast learners
426,24,34,40,98,65,Average learners
427,20,41,22,83,55,Average learners
428,16,15,36,67,44,slow leaners
429,30,40,34,104,69,Average learners
430,13,30,15,58,38,slow leaners
431,34,38,31,103,68,Average learners
432,17,21,19,57,38,slow leaners
433,32,15,18,65,43,slow leaners
434,20,33,33,86,57,Average learners
435,45,13,26,84,56,Average learners
436,31,24,34,89,59,Average learners
437,20,10,32,62,41,slow leaners
438,15,15,40,70,46,slow leaners
439,12,26,27,65,43,slow leaners
440,29,16,49,94,62,Average learners
441,19,43,26,88,58,Average learners
442,22,19,35,76,50,Average learners
443,27,27,47,101,67,Average learners
444,22,17,11,50,33,slow leaners
445,12,33,19,64,42,slow leaners
446,22,18,43,83,55,Average learners
447,21,31,46,98,65,Average learners
448,43,46,37,126,84,fast learners
449,29,12,41,82,54,Average learners
450,38,25,25,88,58,Average learners
451,11,39,19,69,46,slow leaners
452,15,21,36,72,48,slow leaners
453,25,21,46,92,61,Average learners
454,17,13,24,54,36,slow leaners
455,13,23,42,78,52,Average learners
456,36,32,15,83,55,Average learners
457,47,24,36,107,71,fast learners
458,34,45,46,125,83,fast learners
459,16,37,13,66,44,slow leaners
460,12,33,44,89,59,Average learners
461,21,19,26,66,44,slow leaners
462,21,38,23,82,54,Average learners
463,33,47,44,124,82,fast learners
464,21,32,44,97,64,Average learners
465,42,39,46,127,84,fast learners
466,18,36,35,89,59,Average learners
467,28,35,49,112,74,fast learners
468,32,46,36,114,76,fast learners
469,14,30,39,83,55,Average learners
470,20,20,38,78,52,Average learners
471,13,24,24,61,40,slow leaners
472,28,48,43,119,79,fast learners
473,47,18,16,81,54,Average learners
474,44,26,23,93,62,Average learners
475,49,17,24,90,60,Average learners
476,11,43,26,80,53,Average learners
477,26,49,19,94,62,Average learners
478,20,22,36,78,52,Average learners
479,15,20,35,70,46,slow leaners
480,33,11,37,81,54,Average learners
481,37,42,42,121,80,fast learners
482,34,42,16,92,61,Average learners
483,35,27,24,86,57,Average learners
484,22,46,37,105,70,fast learners
485,39,48,13,100,66,Average learners
486,12,25,48,85,56,Average learners
487,29,26,21,76,50,Average learners
488,40,24,42,106,70,fast learners
489,10,21,16,47,31,slow leaners
490,30,14,17,61,40,slow leaners
491,26,12,44,82,54,Average learners
492,25,43,32,100,66,Average learners
493,14,46,23,83,55,Average learners
494,26,25,37,88,58,Average learners
495,41,12,44,97,64,Average learners
496,13,34,13,60,40,slow leaners
497,23,11,18,52,34,slow leaners
498,32,20,30,82,54,Average learners
499,37,47,25,109,72,fast learners
500,34,48,37,119,79,fast learners
501,49,46,12,107,71,fast learners
502,12,12,38,62,41,slow leaners
503,30,11,44,85,56,Average learners
504,27,16,43,86,57,Average learners
505,31,20,13,64,42,slow leaners
506,40,39,15,94,62,Average learners
507,25,29,12,66,44,slow leaners
508,10,23,19,52,34,slow leaners
509,45,13,28,86,57,Average learners
510,14,16,24,54,36,slow leaners
511,26,43,17,86,57,Average learners
512,18,34,15,67,44,slow leaners
513,38,21,48,107,71,fast learners
514,14,13,23,50,33,slow leaners
515,14,33,33,80,53,Average learners
516,40,11,43,94,62,Average learners
517,21,18,43,82,54,Average learners
518,11,34,18,63,42,slow leaners
519,28,19,29,76,50,Average learners
520,25,15,43,83,55,Average learners
521,41,31,41,113,75,fast learners
522,44,15,19,78,52,Average learners
523,36,21,24,81,54,Average learners
524,44,13,14,71,47,slow leaners
525,42,19,15,76,50,Average learners
526,22,31,18,71,47,slow leaners
527,11,38,43,92,61,Average learners
528,35,48,44,127,84,fast learners
529,39,24,34,97,64,Average learners
530,40,30,10,80,53,Average learners
531,25,26,47,98,65,Average learners
532,21,44,44,109,72,fast learners
533,36,33,13,82,54,Average learners
534,27,32,31,90,60,Average learners
535,44,16,10,70,46,slow leaners
536,29,45,34,108,72,fast learners
537,30,21,26,77,51,Average learners
538,40,22,17,79,52,Average learners
539,33,23,41,97,64,Average learners
540,48,17,12,77,51,Average learners
541,42,47,45,134,89,fast learners
542,31,32,11,74,49,slow leaners
543,42,43,48,133,88,fast learners
544,23,38,28,89,59,Average learners
545,10,42,12,64,42,slow leaners
546,30,45,13,88,58,Average learners
547,25,21,32,78,52,Average learners
548,18,41,32,91,60,Average learners
549,35,20,22,77,51,Average learners
550,40,32,13,85,56,Average learners
551,16,17,39,72,48,slow leaners
552,43,27,45,115,76,fast learners
553,44,22,30,96,64,Average learners
554,28,18,43,89,59,Average learners
555,37,21,16,74,49,slow leaners
556,16,34,28,78,52,Average learners
557,23,26,11,60,40,slow leaners
558,24,46,38,108,72,fast learners
559,29,30,47,106,70,fast learners
560,40,43,23,106,70,fast learners
561,19,29,21,69,46,slow leaners
562,36,40,49,125,83,fast learners
563,12,47,48,107,71,fast learners
564,30,10,47,87,58,Average learners
565,37,25,29,91,60,Average learners
566,47,26,18,91,60,Average learners
567,38,15,18,71,47,slow leaners
568,32,20,47,99,66,Average learners
569,39,40,34,113,75,fast learners
570,41,16,28,85,56,Average learners
571,44,27,32,103,68,Average learners
572,17,24,14,55,36,slow leaners
573,33,45,12,90,60,Average learners
574,49,30,45,124,82,fast learners
575,30,32,22,84,56,Average learners
576,16,17,45,78,52,Average learners
577,29,10,23,62,41,slow leaners
578,32,44,41,117,78,fast learners
579,11,37,16,64,42,slow leaners
580,17,15,15,47,31,slow leaners
581,23,16,34,73,48,slow leaners
582,21,40,38,99,66,Average learners
583,14,15,13,42,28,slow leaners
584,26,26,18,70,46,slow leaners
585,15,44,11,70,46,slow leaners
586,21,23,42,86,57,Average learners
587,49,29,31,109,72,fast learners
588,11,13,25,49,32,slow leaners
589,37,40,26,103,68,Average learners
590,15,30,43,88,58,Average learners
591,31,12,29,72,48,slow leaners
592,41,25,44,110,73,fast learners
593,37,44,35,116,77,fast learners
594,28,10,15,53,35,slow leaners
595,26,32,17,75,50,Average learners
596,36,16,45,97,64,Average learners
597,20,35,31,86,57,Average learners
598,39,17,40,96,64,Average learners
599,16,25,20,61,40,slow leaners
600,21,17,21,59,39,slow leaners
601,36,42,37,115,76,fast learners
602,20,17,12,49,32,slow leaners
603,21,13,10,44,29,slow leaners
604,32,34,17,83,55,Average learners
605,24,18,37,79,52,Average learners
606,46,11,30,87,58,Average learners
607,43,13,37,93,62,Average learners
608,33,44,34,111,74,fast learners
609,27,14,16,57,38,slow leaners
610,34,14,26,74,49,slow leaners
611,29,47,32,108,72,fast learners
612,30,47,40,117,78,fast learners
613,48,33,31,112,74,fast learners
614,14,33,45,92,61,Average learners
615,24,40,10,74,49,slow leaners
616,12,19,12,43,28,slow leaners
617,21,31,24,76,50,Average learners
618,33,28,14,75,50,Average learners
619,42,27,43,112,74,fast learners
620,41,23,20,84,56,Average learners
621,20,40,41,101,67,Average learners
622,35,21,46,102,68,Average learners
623,46,15,25,86,57,Average learners
624,48,41,33,122,81,fast learners
625,41,13,17,71,47,slow leaners
626,16,11,27,54,36,slow leaners
627,22,19,41,82,54,Average learners
628,13,12,49,74,49,slow leaners
629,32,26,46,104,69,Average learners
630,28,36,44,108,72,fast learners
631,34,47,46,127,84,fast learners
632,35,18,35,88,58,Average learners
633,15,38,14,67,44,slow leaners
634,12,17,39,68,45,slow leaners
635,17,25,36,78,52,Average learners
636,44,36,45,125,83,fast learners
637,13,14,20,47,31,slow leaners
638,41,39,12,92,61,Average learners
639,13,21,47,81,54,Average learners
640,32,34,29,95,63,Average learners
641,46,21,13,80,53,Average learners
642,25,29,25,79,52,Average learners
643,46,36,17,99,66,Average learners
644,11,29,46,86,57,Average learners
645,40,40,17,97,64,Average learners
646,28,16,35,79,52,Average learners
647,27,29,12,68,45,slow leaners
648,15,11,22,48,32,slow leaners
649,37,48,10,95,63,Average learners
650,37,20,45,102,68,Average learners
651,45,13,42,100,66,Average learners
652,40,11,42,93,62,Average learners
653,19,34,10,63,42,slow leaners
654,14,10,48,72,48,slow leaners
655,39,27,29,95,63,Average learners
656,47,38,35,120,80,fast learners
657,47,22,38,107,71,fast learners
658,12,30,15,57,38,slow leaners
659,10,34,29,73,48,slow leaners
660,34,10,41,85,56,Average learners
661,29,45,33,107,71,fast learners
662,44,22,14,80,53,Average learners
663,34,35,33,102,68,Average learners
664,14,29,29,72,48,slow leaners
665,10,15,22,47,31,slow leaners
666,33,32,42,107,71,fast learners
667,31,41,16,88,58,Average learners
668,33,11,25,69,46,slow leaners
669,31,17,38,86,57,Average learners
670,21,41,21,83,55,Average learners
671,30,37,30,97,64,Average learners
672,35,28,21,84,56,Average learners
673,12,37,25,74,49,slow leaners
674,20,16,39,75,50,Average learners
675,49,43,36,128,85,fast learners
676,34,12,33,79,52,Average learners
677,41,11,49,101,67,Average learners
678,10,20,45,75,50,Average learners
679,16,26,26,68,45,slow leaners
680,23,45,40,108,72,fast learners
681,31,46,32,109,72,fast learners
682,38,38,38,114,76,fast learners
683,19,38,23,80,53,Average learners
684,24,41,47,112,74,fast learners
685,30,21,24,75,50,Average learners
686,46,41,15,102,68,Average learners
687,38,25,36,99,66,Average learners
688,47,18,31,96,64,Average learners
689,28,31,41,100,66,Average learners
690,23,14,10,47,31,slow leaners
691,10,32,33,75,50,Average learners
692,42,38,25,105,70,fast learners
693,10,14,28,52,34,slow leaners
694,11,42,23,76,50,Average learners
695,31,25,28,84,56,Average learners
696,41,13,44,98,65,Average learners
697,25,21,18,64,42,slow leaners
698,42,41,14,97,64,Average learners
699,24,44,14,82,54,Average learners
700,49,34,24,107,71,fast learners
701,39,23,37,99,66,Average learners
702,39,46,12,97,64,Average learners
703,12,19,22,53,35,slow leaners
704,39,24,10,73,48,slow leaners
705,10,30,23,63,42,slow leaners
706,36,17,47,100,66,Average learners
707,47,49,19,115,76,fast learners
708,15,26,37,78,52,Average learners
709,38,26,44,108,72,fast learners
710,42,34,10,86,57,Average learners
711,15,43,11,69,46,slow leaners
712,42,27,17,86,57,Average learners
713,48,46,34,128,85,fast learners
714,19,24,15,58,38,slow leaners
715,10,11,22,43,28,slow leaners
716,22,29,43,94,62,Average learners
717,20,39,36,95,63,Average learners
718,35,40,19,94,62,Average learners
719,35,30,18,83,55,Average learners
720,26,36,46,108,72,fast learners
721,25,20,18,63,42,slow leaners
722,34,20,23,77,51,Average learners
723,24,31,49,104,69,Average learners
724,36,27,12,75,50,Average learners
725,31,18,22,71,47,slow leaners
726,29,39,22,90,60,Average learners
727,30,25,43,98,65,Average learners
728,24,30,47,101,67,Average learners
729,31,13,21,65,43,slow leaners
730,48,28,18,94,62,Average learners
731,34,26,48,108,72,fast learners
732,20,24,45,89,59,Average learners
733,33,15,12,60,40,slow leaners
734,33,34,18,85,56,Average learners
735,38,47,17,102,68,Average learners
736,17,34,46,97,64,Average learners
737,48,26,44,118,78,fast learners
738,49,31,13,93,62,Average learners
739,38,14,49,101,67,Average learners
740,17,30,36,83,55,Average learners
741,24,27,10,61,40,slow leaners
742,18,36,34,88,58,Average learners
743,38,35,21,94,62,Average learners
744,14,15,32,61,40,slow leaners
745,26,15,37,78,52,Average learners
746,24,21,39,84,56,Average learners
747,10,13,21,44,29,slow leaners
748,33,29,20,82,54,Average learners
749,13,24,47,84,56,Average learners
750,23,41,20,84,56,Average learners
751,45,36,18,99,66,Average learners
752,45,14,24,83,55,Average learners
753,11,20,17,48,32,slow leaners
754,30,36,47,113,75,fast learners
755,37,43,18,98,65,Average learners
756,44,47,37,128,85,fast learners
757,14,32,18,64,42,slow leaners
758,30,20,32,82,54,Average learners
759,40,16,33,89,59,Average learners
760,30,45,43,118,78,fast learners
761,26,28,18,72,48,slow leaners
762,38,38,49,125,83,fast learners
763,28,22,47,97,64,Average learners
764,43,16,35,94,62,Average learners
765,47,29,13,89,59,Average learners
766,45,24,46,115,76,fast learners
767,43,30,25,98,65,Average learners
768,44,13,25,82,54,Average learners
769,46,18,24,88,58,Average learners
770,14,48,26,88,58,Average learners
771,43,37,17,97,64,Average learners
772,24,49,14,87,58,Average learners
773,25,43,47,115,76,fast learners
774,14,27,48,89,59,Average learners
775,15,47,29,91,60,Average learners
776,38,31,10,79,52,Average learners
777,32,44,10,86,57,Average learners
778,24,35,47,106,70,fast learners
779,15,32,27,74,49,slow leaners
780,18,48,18,84,56,Average learners
781,42,45,16,103,68,Average learners
782,24,39,12,75,50,Average learners
783,43,47,33,123,82,fast learners
784,34,39,37,110,73,fast learners
785,21,48,45,114,76,fast learners
786,17,40,41,98,65,Average learners
787,44,28,34,106,70,fast learners
788,43,42,49,134,89,fast learners
789,13,17,13,43,28,slow leaners
790,45,17,49,111,74,fast learners
791,41,44,15,100,66,Average learners
792,49,13,42,104,69,Average learners
793,23,12,47,82,54,Average learners
794,20,21,30,71,47,slow leaners
795,47,41,26,114,76,fast learners
796,29,11,22,62,41,slow leaners
797,29,28,12,69,46,slow leaners
798,20,12,15,47,31,slow leaners
799,46,33,35,114,76,fast learners
800,18,12,38,68,45,slow leaners
801,26,18,42,86,57,Average learners
802,39,47,41,127,84,fast learners
803,32,34,14,80,53,Average learners
804,20,33,32,85,56,Average learners
805,13,43,13,69,46,slow leaners
806,26,48,46,120,80,fast learners
807,27,13,48,88,58,Average learners
808,11,39,22,72,48,slow leaners
809,10,34,48,92,61,Average learners
810,31,35,14,80,53,Average learners
811,14,26,31,71,47,slow leaners
812,14,44,19,77,51,Average learners
813,35,15,23,73,48,slow leaners
814,31,48,27,106,70,fast learners
815,34,13,30,77,51,Average learners
816,19,34,39,92,61,Average learners
817,33,17,24,74,49,slow leaners
818,26,33,14,73,48,slow leaners
819,12,14,28,54,36,slow leaners
820,35,32,41,108,72,fast learners
821,44,40,13,97,64,Average learners
822,40,22,46,108,72,fast learners
823,23,37,13,73,48,slow leaners
824,43,40,49,132,88,fast learners
825,39,20,32,91,60,Average learners
826,22,42,47,111,74,fast learners
827,44,21,47,112,74,fast learners
828,24,40,18,82,54,Average learners
829,27,24,37,88,58,Average learners
830,10,29,18,57,38,slow leaners
831,29,25,25,79,52,Average learners
832,30,49,31,110,73,fast learners
833,19,25,30,74,49,slow leaners
834,41,19,18,78,52,Average learners
835,45,37,20,102,68,Average learners
836,18,49,11,78,52,Average learners
837,16,24,15,55,36,slow leaners
838,17,38,38,93,62,Average learners
839,22,33,19,74,49,slow leaners
840,27,28,11,66,44,slow leaners
841,29,25,31,85,56,Average learners
842,44,40,48,132,88,fast learners
843,27,30,28,85,56,Average learners
844,20,32,22,74,49,slow leaners
845,17,29,16,62,41,slow leaners
846,26,20,22,68,45,slow leaners
847,29,18,40,87,58,Average learners
848,36,48,18,102,68,Average learners
849,37,45,43,125,83,fast learners
850,14,40,43,97,64,Average learners
851,48,28,43,119,79,fast learners
852,17,17,23,57,38,slow leaners
853,34,22,24,80,53,Average learners
854,45,23,15,83,55,Average learners
855,15,31,18,64,42,slow leaners
856,42,31,22,95,63,Average learners
857,31,20,36,87,58,Average learners
858,40,33,34,107,71,fast learners
859,27,44,12,83,55,Average learners
860,38,16,32,86,57,Average learners
861,34,43,28,105,70,fast learners
862,11,45,12,68,45,slow leaners
863,44,46,43,133,88,fast learners
864,32,10,41,83,55,Average learners
865,40,29,41,110,73,fast learners
866,35,29,27,91,60,Average learners
867,36,45,14,95,63,Average learners
868,39,20,13,72,48,slow leaners
869,48,37,24,109,72,fast learners
870,39,33,28,100,66,Average learners
871,46,32,16,94,62,Average learners
872,16,45,12,73,48,slow leaners
873,39,43,32,114,76,fast learners
874,28,15,23,66,44,slow leaners
875,46,37,44,127,84,fast learners
876,27,37,20,84,56,Average learners
877,33,17,23,73,48,slow leaners
878,33,12,15,60,40,slow leaners
879,32,20,19,71,47,slow leaners
880,45,28,29,102,68,Average learners
881,47,45,12,104,69,Average learners
882,27,48,43,118,78,fast learners
883,39,12,32,83,55,Average learners
884,46,42,22,110,73,fast learners
885,46,33,19,98,65,Average learners
886,40,22,38,100,66,Average learners
887,49,32,20,101,67,Average learners
888,25,19,35,79,52,Average learners
889,49,30,18,97,64,Average learners
890,39,37,23,99,66,Average learners
891,22,15,40,77,51,Average learners
892,11,42,33,86,57,Average learners
893,36,22,33,91,60,Average learners
894,35,30,27,92,61,Average learners
895,38,29,26,93,62,Average learners
896,17,32,22,71,47,slow leaners
897,32,42,13,87,58,Average learners
898,18,48,44,110,73,fast learners
899,41,36,49,126,84,fast learners
900,38,23,21,82,54,Average learners
901,38,28,25,91,60,Average learners
902,14,15,11,40,26,slow leaners
903,48,15,19,82,54,Average learners
904,20,11,11,42,28,slow leaners
905,30,12,32,74,49,slow leaners
906,35,12,29,76,50,Average learners
907,22,27,15,64,42,slow leaners
908,31,21,18,70,46,slow leaners
909,24,38,30,92,61,Average learners
910,26,33,24,83,55,Average learners
911,23,48,33,104,69,Average learners
912,43,27,48,118,78,fast learners
913,18,15,27,60,40,slow leaners
914,32,35,39,106,70,fast learners
915,45,37,42,124,82,fast learners
916,24,37,33,94,62,Average learners
917,39,20,37,96,64,Average learners
918,42,39,26,107,71,fast learners
919,24,12,42,78,52,Average learners
920,19,47,37,103,68,Average learners
921,25,31,34,90,60,Average learners
922,28,38,32,98,65,Average learners
923,39,38,14,91,60,Average learners
924,43,43,21,107,71,fast learners
925,42,32,13,87,58,Average learners
926,14,12,41,67,44,slow leaners
927,11,44,33,88,58,Average learners
928,47,17,14,78,52,Average learners
929,36,35,41,112,74,fast learners
930,48,11,42,101,67,Average learners
931,17,18,27,62,41,slow leaners
932,10,11,35,56,37,slow leaners
933,12,20,49,81,54,Average learners
934,47,38,10,95,63,Average learners
935,39,26,39,104,69,Average learners
936,17,33,47,97,64,Average learners
937,21,11,35,67,44,slow leaners
938,13,15,31,59,39,slow leaners
939,27,20,11,58,38,slow leaners
940,44,37,19,100,66,Average learners
941,26,28,10,64,42,slow leaners
942,31,16,25,72,48,slow leaners
943,25,34,21,80,53,Average learners
944,19,44,32,95,63,Average learners
945,17,20,39,76,50,Average learners
946,43,14,14,71,47,slow leaners
947,32,25,33,90,60,Average learners
948,39,13,18,70,46,slow leaners
949,11,32,48,91,60,Average learners
950,26,28,15,69,46,slow leaners
951,18,22,14,54,36,slow leaners
952,48,29,42,119,79,fast learners
953,19,30,21,70,46,slow leaners
954,49,23,13,85,56,Average learners
955,16,42,23,81,54,Average learners
956,45,21,13,79,52,Average learners
957,14,16,31,61,40,slow leaners
958,32,48,15,95,63,Average learners
959,12,18,48,78,52,Average learners
960,41,13,41,95,63,Average learners
961,43,34,11,88,58,Average learners
962,18,13,22,53,35,slow leaners
963,25,48,32,105,70,fast learners
964,46,33,25,104,69,Average learners
965,32,48,48,128,85,fast learners
966,12,26,32,70,46,slow leaners
967,43,49,43,135,90,fast learners
968,13,25,41,79,52,Average learners
969,19,34,20,73,48,slow leaners
970,36,44,44,124,82,fast learners
971,11,11,34,56,37,slow leaners
972,27,27,21,75,50,Average learners
973,19,33,34,86,57,Average learners
974,43,23,45,111,74,fast learners
975,43,26,10,79,52,Average learners
976,16,16,24,56,37,slow leaners
977,12,46,30,88,58,Average learners
978,20,30,21,71,47,slow leaners
979,34,39,32,105,70,fast learners
980,41,16,38,95,63,Average learners
981,34,20,31,85,56,Average learners
982,49,30,25,104,69,Average learners
983,15,29,15,59,39,slow leaners
984,32,22,26,80,53,Average learners
985,14,18,27,59,39,slow leaners
986,32,25,16,73,48,slow leaners
987,42,34,23,99,66,Average learners
988,11,23,32,66,44,slow leaners
989,49,20,49,118,78,fast learners
990,36,38,45,119,79,fast learners
991,25,10,26,61,40,slow leaners
992,18,39,25,82,54,Average learners
993,28,38,18,84,56,Average learners
994,40,24,29,93,62,Average learners
995,48,33,15,96,64,Average learners
996,32,41,37,110,73,fast learners
997,14,11,44,69,46,slow leaners
998,30,10,11,51,34,slow leaners
999,13,27,11,51,34,slow leaners
1000,38,32,24,94,62,Average learners
1001,25,39,48,112,74,fast learners
1002,25,47,42,114,76,fast learners
1003,40,48,30,118,78,fast learners
1004,28,17,17,62,41,slow leaners
1005,20,16,42,78,52,Average learners
1006,25,37,11,73,48,slow leaners
1007,44,38,36,118,78,fast learners
1008,46,45,42,133,88,fast learners
1009,35,49,37,121,80,fast learners
1010,47,24,13,84,56,Average learners
1011,13,33,43,89,59,Average learners
1012,28,38,25,91,60,Average learners
1013,28,43,45,116,77,fast learners
1014,24,10,24,58,38,slow leaners
1015,10,15,15,40,26,slow leaners
1016,23,30,40,93,62,Average learners
1017,21,24,36,81,54,Average learners
1018,36,47,39,122,81,fast learners
1019,48,30,14,92,61,Average learners
1020,45,31,21,97,64,Average learners
1021,29,28,18,75,50,Average learners
1022,35,33,25,93,62,Average learners
1023,39,34,38,111,74,fast learners
1024,48,11,42,101,67,Average learners
1025,41,47,13,101,67,Average learners
1026,26,28,17,71,47,slow leaners
1027,36,33,29,98,65,Average learners
1028,17,37,35,89,59,Average learners
1029,32,23,22,77,51,Average learners
1030,41,20,42,103,68,Average learners
1031,31,48,16,95,63,Average learners
1032,48,11,25,84,56,Average learners
1033,46,47,20,113,75,fast learners
1034,39,19,32,90,60,Average learners
1035,37,49,37,123,82,fast learners
1036,37,35,23,95,63,Average learners
1037,49,23,16,88,58,Average learners
1038,30,32,14,76,50,Average learners
1039,32,16,27,75,50,Average learners
1040,23,36,30,89,59,Average learners
1041,48,45,32,125,83,fast learners
1042,31,38,24,93,62,Average learners
1043,31,33,26,90,60,Average learners
1044,32,12,29,73,48,slow leaners
1045,30,14,48,92,61,Average learners
1046,16,38,42,96,64,Average learners
1047,18,28,14,60,40,slow leaners
1048,42,20,17,79,52,Average learners
1049,11,11,36,58,38,slow leaners
1050,24,36,17,77,51,Average learners
1051,40,38,26,104,69,Average learners
1052,40,35,14,89,59,Average learners
1053,35,41,49,125,83,fast learners
1054,18,29,34,81,54,Average learners
1055,13,45,25,83,55,Average learners
1056,25,15,48,88,58,Average learners
1057,38,43,29,110,73,fast learners
1058,33,12,23,68,45,slow leaners
1059,13,36,36,85,56,Average learners
1060,45,15,20,80,53,Average learners
1061,30,10,19,59,39,slow leaners
1062,38,26,14,78,52,Average learners
1063,43,39,39,121,80,fast learners
1064,17,47,24,88,58,Average learners
1065,24,33,28,85,56,Average learners
1066,16,14,46,76,50,Average learners
1067,17,37,10,64,42,slow leaners
1068,20,40,17,77,51,Average learners
1069,43,38,44,125,83,fast learners
1070,29,34,31,94,62,Average learners
1071,23,11,14,48,32,slow leaners
1072,35,32,29,96,64,Average learners
1073,32,40,41,113,75,fast learners
1074,10,20,10,40,26,slow leaners
1075,13,13,46,72,48,slow leaners
1076,30,25,44,99,66,Average learners
1077,19,45,32,96,64,Average learners
1078,17,33,10,60,40,slow leaners
1079,17,33,25,75,50,Average learners
1080,18,29,21,68,45,slow leaners
1081,34,17,29,80,53,Average learners
1082,19,17,30,66,44,slow leaners
1083,47,19,36,102,68,Average learners
1084,12,14,39,65,43,slow leaners
1085,10,44,35,89,59,Average learners
1086,27,42,40,109,72,fast learners
1087,18,25,13,56,37,slow leaners
1088,43,39,34,116,77,fast learners
1089,29,21,48,98,65,Average learners
1090,41,27,42,110,73,fast learners
1091,40,47,38,125,83,fast learners
1092,26,14,41,81,54,Average learners
1093,15,33,49,97,64,Average learners
1094,47,15,46,108,72,fast learners
1095,33,31,12,76,50,Average learners
1096,21,46,27,94,62,Average learners
1097,42,49,38,129,86,fast learners
1098,35,46,45,126,84,fast learners
1099,37,44,40,121,80,fast learners
1100,49,45,25,119,79,fast learners
1101,32,20,18,70,46,slow leaners
1102,26,16,24,66,44,slow leaners
1103,21,36,48,105,70,fast learners
1104,23,22,16,61,40,slow leaners
1105,36,17,40,93,62,Average learners
1106,11,42,23,76,50,Average learners
1107,21,49,38,108,72,fast learners
1108,32,36,41,109,72,fast learners
1109,45,27,18,90,60,Average learners
1110,38,21,31,90,60,Average learners
1111,18,15,49,82,54,Average learners
1112,31,21,22,74,49,slow leaners
1113,12,42,25,79,52,Average learners
1114,35,16,36,87,58,Average learners
1115,21,39,35,95,63,Average learners
1116,13,41,42,96,64,Average learners
1117,37,36,15,88,58,Average learners
1118,20,39,40,99,66,Average learners
1119,42,15,10,67,44,slow leaners
1120,47,16,11,74,49,slow leaners
1121,49,14,46,109,72,fast learners
1122,25,45,35,105,70,fast learners
1123,34,33,20,87,58,Average learners
1124,44,18,35,97,64,Average learners
1125,19,18,22,59,39,slow leaners
1126,23,46,40,109,72,fast learners
1127,41,22,18,81,54,Average learners
1128,46,43,20,109,72,fast learners
1129,32,41,20,93,62,Average learners
1130,17,17,44,78,52,Average learners
1131,10,20,23,53,35,slow leaners
1132,41,24,21,86,57,Average learners
1133,28,39,24,91,60,Average learners
1134,31,47,23,101,67,Average learners
1135,32,44,36,112,74,fast learners
1136,30,45,37,112,74,fast learners
1137,37,18,24,79,52,Average learners
1138,44,17,44,105,70,fast learners
1139,38,40,11,89,59,Average learners
1140,43,26,41,110,73,fast learners
1141,35,18,29,82,54,Average learners
1142,34,43,23,100,66,Average learners
1143,44,41,32,117,78,fast learners
1144,31,33,26,90,60,Average learners
1145,19,11,23,53,35,slow leaners
1146,22,11,44,77,51,Average learners
1147,33,21,16,70,46,slow leaners
1148,19,36,25,80,53,Average learners
1149,49,39,39,127,84,fast learners
1150,11,45,26,82,54,Average learners
1151,37,17,38,92,61,Average learners
1152,24,23,32,79,52,Average learners
1153,42,34,41,117,78,fast learners
1154,34,34,31,99,66,Average learners
1155,30,19,44,93,62,Average learners
1156,41,19,15,75,50,Average learners
1157,24,32,41,97,64,Average learners
1158,42,22,48,112,74,fast learners
1159,17,33,28,78,52,Average learners
1160,18,39,16,73,48,slow leaners
1161,44,23,46,113,75,fast learners
1162,17,21,38,76,50,Average learners
1163,43,43,43,129,86,fast learners
1164,43,44,25,112,74,fast learners
1165,42,12,19,73,48,slow leaners
1166,32,35,39,106,70,fast learners
1167,40,47,19,106,70,fast learners
1168,26,40,30,96,64,Average learners
1169,44,46,33,123,82,fast learners
1170,41,39,43,123,82,fast learners
1171,28,12,34,74,49,slow leaners
1172,36,45,28,109,72,fast learners
1173,40,16,47,103,68,Average learners
1174,17,45,22,84,56,Average learners
1175,40,12,21,73,48,slow leaners
1176,25,48,24,97,64,Average learners
1177,40,29,37,106,70,fast learners
1178,47,36,41,124,82,fast learners
1179,23,10,13,46,30,slow leaners
1180,19,31,19,69,46,slow leaners
1181,46,19,42,107,71,fast learners
1182,23,44,19,86,57,Average learners
1183,25,20,22,67,44,slow leaners
1184,23,14,10,47,31,slow leaners
1185,23,38,34,95,63,Average learners
1186,49,49,26,124,82,fast learners
1187,13,37,31,81,54,Average learners
1188,13,43,15,71,47,slow leaners
1189,10,11,33,54,36,slow leaners
1190,30,35,34,99,66,Average learners
1191,17,38,10,65,43,slow leaners
1192,40,11,19,70,46,slow leaners
1193,13,44,34,91,60,Average learners
1194,30,45,44,119,79,fast learners
1195,44,44,45,133,88,fast learners
1196,32,29,37,98,65,Average learners
1197,14,22,45,81,54,Average learners
1198,38,29,32,99,66,Average learners
1199,22,46,49,117,78,fast learners
1200,28,16,23,67,44,slow leaners
1201,29,26,33,88,58,Average learners
1202,11,35,38,84,56,Average learners
1203,19,14,17,50,33,slow leaners
1204,41,10,34,85,56,Average learners
1205,16,33,48,97,64,Average learners
1206,12,22,19,53,35,slow leaners
1207,31,25,43,99,66,Average learners
1208,44,20,24,88,58,Average learners
1209,31,11,19,61,40,slow leaners
1210,44,48,27,119,79,fast learners
1211,44,38,29,111,74,fast learners
1212,48,40,17,105,70,fast learners
1213,32,24,40,96,64,Average learners
1214,40,18,42,100,66,Average learners
1215,30,18,14,62,41,slow leaners
1216,42,27,17,86,57,Average learners
1217,37,19,46,102,68,Average learners
1218,27,13,26,66,44,slow leaners
1219,48,41,15,104,69,Average learners
1220,48,42,15,105,70,fast learners
1221,20,38,18,76,50,Average learners
1222,13,10,46,69,46,slow leaners
1223,24,42,24,90,60,Average learners
1224,10,43,42,95,63,Average learners
1225,11,47,32,90,60,Average learners
1226,21,40,10,71,47,slow leaners
1227,25,33,17,75,50,Average learners
1228,13,28,28,69,46,slow leaners
1229,41,21,35,97,64,Average learners
1230,13,43,27,83,55,Average learners
1231,37,44,22,103,68,Average learners
1232,40,33,39,112,74,fast learners
1233,10,16,42,68,45,slow leaners
1234,41,38,42,121,80,fast learners
1235,47,36,26,109,72,fast learners
1236,21,33,37,91,60,Average learners
1237,49,33,37,119,79,fast learners
1238,42,30,45,117,78,fast learners
1239,16,29,42,87,58,Average learners
1240,34,20,45,99,66,Average learners
1241,42,46,42,130,86,fast learners
1242,20,24,32,76,50,Average learners
1243,33,14,19,66,44,slow leaners
1244,28,13,42,83,55,Average learners
1245,16,38,49,103,68,Average learners
1246,47,22,37,106,70,fast learners
1247,25,24,30,79,52,Average learners
1248,23,32,32,87,58,Average learners
1249,34,40,17,91,60,Average learners
1250,38,14,28,80,53,Average learners
1251,27,12,16,55,36,slow leaners
1252,20,19,19,58,38,slow leaners
1253,18,40,12,70,46,slow leaners
1254,38,33,35,106,70,fast learners
1255,49,29,13,91,60,Average learners
1256,39,19,23,81,54,Average learners
1257,16,34,10,60,40,slow leaners
1258,18,48,36,102,68,Average learners
1259,45,38,48,131,87,fast learners
1260,44,31,44,119,79,fast learners
1261,39,26,39,104,69,Average learners
1262,41,37,35,113,75,fast learners
1263,13,27,19,59,39,slow leaners
1264,33,35,22,90,60,Average learners
1265,40,45,49,134,89,fast learners
1266,15,12,40,67,44,slow leaners
1267,34,49,43,126,84,fast learners
1268,21,18,47,86,57,Average learners
1269,15,14,10,39,26,slow leaners
1270,41,45,23,109,72,fast learners
1271,13,33,26,72,48,slow leaners
1272,24,29,31,84,56,Average learners
1273,20,26,15,61,40,slow leaners
1274,25,43,16,84,56,Average learners
1275,39,18,13,70,46,slow leaners
1276,34,39,20,93,62,Average learners
1277,29,36,11,76,50,Average learners
1278,47,21,12,80,53,Average learners
1279,24,28,11,63,42,slow leaners
1280,40,46,49,135,90,fast learners
1281,29,28,38,95,63,Average learners
1282,29,19,28,76,50,Average learners
1283,39,32,41,112,74,fast learners
1284,40,42,27,109,72,fast learners
1285,33,24,32,89,59,Average learners
1286,39,36,14,89,59,Average learners
1287,15,38,40,93,62,Average learners
1288,38,19,28,85,56,Average learners
1289,21,13,32,66,44,slow leaners
1290,24,37,23,84,56,Average learners
1291,40,38,12,90,60,Average learners
1292,21,35,42,98,65,Average learners
1293,36,26,38,100,66,Average learners
1294,18,39,47,104,69,Average learners
1295,33,29,43,105,70,fast learners
1296,42,24,17,83,55,Average learners
1297,23,49,46,118,78,fast learners
1298,34,34,32,100,66,Average learners
1299,14,13,35,62,41,slow leaners
1300,13,21,48,82,54,Average learners
1301,21,12,37,70,46,slow leaners
1302,26,26,24,76,50,Average learners
1303,33,44,14,91,60,Average learners
1304,23,40,42,105,70,fast learners
1305,27,11,24,62,41,slow leaners
1306,41,12,20,73,48,slow leaners
1307,19,30,23,72,48,slow leaners
1308,22,39,25,86,57,Average learners
1309,20,47,26,93,62,Average learners
1310,47,49,42,138,92,fast learners
1311,17,13,14,44,29,slow leaners
1312,12,13,44,69,46,slow leaners
1313,28,42,21,91,60,Average learners
1314,23,18,16,57,38,slow leaners
1315,15,21,13,49,32,slow leaners
1316,14,37,15,66,44,slow leaners
1317,41,20,46,107,71,fast learners
1318,45,19,43,107,71,fast learners
1319,35,18,45,98,65,Average learners
1320,28,35,46,109,72,fast learners
1321,11,23,31,65,43,slow leaners
1322,36,42,43,121,80,fast learners
1323,45,14,36,95,63,Average learners
1324,35,31,32,98,65,Average learners
1325,31,36,20,87,58,Average learners
1326,21,29,36,86,57,Average learners
1327,39,41,20,100,66,Average learners
1328,10,29,26,65,43,slow leaners
1329,23,21,10,54,36,slow leaners
1330,44,38,38,120,80,fast learners
1331,38,39,49,126,84,fast learners
1332,17,44,48,109,72,fast learners
1333,19,16,23,58,38,slow leaners
1334,30,37,37,104,69,Average learners
1335,43,33,10,86,57,Average learners
1336,31,45,46,122,81,fast learners
1337,21,32,23,76,50,Average learners
1338,32,40,45,117,78,fast learners
1339,48,16,22,86,57,Average learners
1340,40,40,21,101,67,Average learners
1341,38,20,42,100,66,Average learners
1342,35,38,14,87,58,Average learners
1343,12,32,44,88,58,Average learners
1344,49,30,40,119,79,fast learners
1345,46,25,14,85,56,Average learners
1346,13,31,23,67,44,slow leaners
1347,20,17,24,61,40,slow leaners
1348,42,30,30,102,68,Average learners
1349,25,36,29,90,60,Average learners
1350,47,32,39,118,78,fast learners
1351,38,37,19,94,62,Average learners
1352,14,26,28,68,45,slow leaners
1353,38,23,39,100,66,Average learners
1354,37,49,36,122,81,fast learners
1355,11,16,27,54,36,slow leaners
1356,24,47,30,101,67,Average learners
1357,48,32,35,115,76,fast learners
1358,41,46,36,123,82,fast learners
1359,12,46,43,101,67,Average learners
1360,41,45,35,121,80,fast learners
1361,35,33,32,100,66,Average learners
1362,28,36,19,83,55,Average learners
1363,46,12,16,74,49,slow leaners
1364,35,43,35,113,75,fast learners
1365,46,27,23,96,64,Average learners
1366,45,13,33,91,60,Average learners
1367,44,20,19,83,55,Average learners
1368,39,20,38,97,64,Average learners
1369,34,44,37,115,76,fast learners
1370,11,47,14,72,48,slow leaners
1371,20,45,11,76,50,Average learners
1372,21,25,25,71,47,slow leaners
1373,32,35,11,78,52,Average learners
1374,49,44,45,138,92,fast learners
1375,41,47,24,112,74,fast learners
1376,43,38,33,114,76,fast learners
1377,16,14,34,64,42,slow leaners
1378,35,48,48,131,87,fast learners
1379,22,23,49,94,62,Average learners
1380,43,43,16,102,68,Average learners
1381,41,13,27,81,54,Average learners
1382,40,48,47,135,90,fast learners
1383,14,42,32,88,58,Average learners
1384,29,38,22,89,59,Average learners
1385,20,13,13,46,30,slow leaners
1386,49,31,24,104,69,Average learners
1387,36,26,31,93,62,Average learners
1388,30,36,43,109,72,fast learners
1389,15,37,20,72,48,slow leaners
1390,43,29,37,109,72,fast learners
1391,25,12,28,65,43,slow leaners
1392,26,22,21,69,46,slow leaners
1393,38,16,13,67,44,slow leaners
1394,32,26,48,106,70,fast learners
1395,49,21,11,81,54,Average learners
1396,42,36,18,96,64,Average learners
1397,33,36,15,84,56,Average learners
1398,21,30,40,91,60,Average learners
1399,22,13,41,76,50,Average learners
1400,32,10,33,75,50,Average learners
1401,39,37,26,102,68,Average learners
1402,30,38,43,111,74,fast learners
1403,20,35,33,88,58,Average learners
1404,11,16,37,64,42,slow leaners
1405,21,16,13,50,33,slow leaners
1406,31,29,35,95,63,Average learners
1407,44,49,28,121,80,fast learners
1408,32,35,24,91,60,Average learners
1409,36,36,36,108,72,fast learners
1410,44,47,39,130,86,fast learners
1411,29,42,32,103,68,Average learners
1412,33,43,44,120,80,fast learners
1413,23,29,12,64,42,slow leaners
1414,43,35,45,123,82,fast learners
1415,10,12,37,59,39,slow leaners
1416,38,23,19,80,53,Average learners
1417,40,22,38,100,66,Average learners
1418,19,19,13,51,34,slow leaners
1419,22,48,21,91,60,Average learners
1420,17,25,20,62,41,slow leaners
1421,23,29,48,100,66,Average learners
1422,26,44,42,112,74,fast learners
1423,24,38,38,100,66,Average learners
1424,21,15,27,63,42,slow leaners
1425,47,45,41,133,88,fast learners
1426,42,30,26,98,65,Average learners
1427,12,13,48,73,48,slow leaners
1428,43,37,14,94,62,Average learners
1429,36,28,30,94,62,Average learners
1430,28,20,13,61,40,slow leaners
1431,23,10,24,57,38,slow leaners
1432,20,26,26,72,48,slow leaners
1433,13,31,44,88,58,Average learners
1434,13,29,41,83,55,Average learners
1435,21,45,15,81,54,Average learners
1436,25,41,26,92,61,Average learners
1437,34,12,14,60,40,slow leaners
1438,34,25,29,88,58,Average learners
1439,36,13,17,66,44,slow leaners
1440,32,25,32,89,59,Average learners
1441,15,46,25,86,57,Average learners
1442,39,28,32,99,66,Average learners
1443,38,46,37,121,80,fast learners
1444,40,10,43,93,62,Average learners
1445,27,11,37,75,50,Average learners
1446,27,16,31,74,49,slow leaners
1447,39,24,16,79,52,Average learners
1448,23,34,45,102,68,Average learners
1449,16,21,17,54,36,slow leaners
1450,12,39,18,69,46,slow leaners
1451,20,30,17,67,44,slow leaners
1452,17,42,40,99,66,Average learners
1453,31,29,15,75,50,Average learners
1454,21,40,23,84,56,Average learners
1455,30,43,12,85,56,Average learners
1456,38,12,29,79,52,Average learners
1457,47,44,39,130,86,fast learners
1458,17,27,20,64,42,slow leaners
1459,35,28,30,93,62,Average learners
1460,35,45,36,116,77,fast learners
1461,47,15,29,91,60,Average learners
1462,28,12,28,68,45,slow leaners
1463,10,24,34,68,45,slow leaners
1464,27,19,16,62,41,slow leaners
1465,29,23,31,83,55,Average learners
1466,12,37,42,91,60,Average learners
1467,25,47,22,94,62,Average learners
1468,43,44,17,104,69,Average learners
1469,28,45,37,110,73,fast learners
1470,44,13,43,100,66,Average learners
1471,45,41,48,134,89,fast learners
1472,43,47,44,134,89,fast learners
1473,39,24,18,81,54,Average learners
1474,15,36,44,95,63,Average learners
1475,16,47,42,105,70,fast learners
1476,40,25,24,89,59,Average learners
1477,19,10,27,56,37,slow leaners
1478,28,35,28,91,60,Average learners
1479,33,18,43,94,62,Average learners
1480,26,38,12,76,50,Average learners
1481,28,39,40,107,71,fast learners
1482,48,44,22,114,76,fast learners
1483,40,31,12,83,55,Average learners
1484,31,48,23,102,68,Average learners
1485,28,29,43,100,66,Average learners
1486,10,19,39,68,45,slow leaners
1487,24,43,17,84,56,Average learners
1488,25,20,32,77,51,Average learners
1489,13,33,32,78,52,Average learners
1490,24,37,41,102,68,Average learners
1491,42,37,11,90,60,Average learners
1492,34,44,37,115,76,fast learners
1493,43,17,48,108,72,fast learners
1494,21,11,45,77,51,Average learners
1495,42,35,29,106,70,fast learners
1496,17,26,23,66,44,slow leaners
1497,21,36,20,77,51,Average learners
1498,27,23,11,61,40,slow leaners
1499,11,38,25,74,49,slow leaners
1500,44,38,29,111,74,fast learners
1501,37,20,28,85,56,Average learners
1502,17,30,24,71,47,slow leaners
1503,46,26,32,104,69,Average learners
1504,31,16,49,96,64,Average learners
1505,36,44,40,120,80,fast learners
1506,15,12,20,47,31,slow leaners
1507,41,46,22,109,72,fast learners
1508,32,32,41,105,70,fast learners
1509,44,29,16,89,59,Average learners
1510,37,33,39,109,72,fast learners
1511,13,15,44,72,48,slow leaners
1512,36,25,49,110,73,fast learners
1513,21,29,22,72,48,slow leaners
1514,47,39,33,119,79,fast learners
1515,20,10,16,46,30,slow leaners
1516,22,40,25,87,58,Average learners
1517,20,16,12,48,32,slow leaners
1518,46,28,41,115,76,fast learners
1519,12,49,39,100,66,Average learners
1520,36,45,21,102,68,Average learners
1521,23,31,19,73,48,slow leaners
1522,18,46,48,112,74,fast learners
1523,42,32,48,122,81,fast learners
1524,46,49,43,138,92,fast learners
1525,17,18,14,49,32,slow leaners
1526,32,24,34,90,60,Average learners
1527,39,14,45,98,65,Average learners
1528,18,33,33,84,56,Average learners
1529,38,23,24,85,56,Average learners
1530,34,43,33,110,73,fast learners
1531,22,44,27,93,62,Average learners
1532,18,29,27,74,49,slow leaners
1533,37,15,29,81,54,Average learners
1534,27,34,12,73,48,slow leaners
1535,24,17,43,84,56,Average learners
1536,45,26,31,102,68,Average learners
1537,19,32,34,85,56,Average learners
1538,19,45,34,98,65,Average learners
1539,36,20,18,74,49,slow leaners
1540,36,28,42,106,70,fast learners
1541,12,12,11,35,23,slow leaners
1542,38,25,28,91,60,Average learners
1543,22,10,41,73,48,slow leaners
1544,27,10,27,64,42,slow leaners
1545,18,31,47,96,64,Average learners
1546,25,35,18,78,52,Average learners
1547,16,43,31,90,60,Average learners
1548,41,15,14,70,46,slow leaners
1549,32,45,14,91,60,Average learners
1550,25,22,41,88,58,Average learners
1551,29,40,21,90,60,Average learners
1552,17,35,14,66,44,slow leaners
1553,29,30,11,70,46,slow leaners
1554,33,39,12,84,56,Average learners
1555,10,26,42,78,52,Average learners
1556,11,47,40,98,65,Average learners
1557,33,36,30,99,66,Average learners
1558,20,10,18,48,32,slow leaners
1559,32,23,37,92,61,Average learners
1560,49,34,32,115,76,fast learners
1561,42,31,42,115,76,fast learners
1562,19,25,27,71,47,slow leaners
1563,25,36,45,106,70,fast learners
1564,40,20,20,80,53,Average learners
1565,16,19,25,60,40,slow leaners
1566,48,32,41,121,80,fast learners
1567,29,18,21,68,45,slow leaners
1568,46,29,15,90,60,Average learners
1569,33,34,49,116,77,fast learners
1570,47,25,12,84,56,Average learners
1571,25,26,25,76,50,Average learners
1572,25,47,26,98,65,Average learners
1573,16,30,12,58,38,slow leaners
1574,37,32,37,106,70,fast learners
1575,18,39,38,95,63,Average learners
1576,49,31,11,91,60,Average learners
1577,49,33,43,125,83,fast learners
1578,14,37,31,82,54,Average learners
1579,22,22,19,63,42,slow leaners
1580,45,43,12,100,66,Average learners
1581,35,30,37,102,68,Average learners
1582,38,38,11,87,58,Average learners
1583,12,45,38,95,63,Average learners
1584,29,19,17,65,43,slow leaners
1585,14,21,32,67,44,slow leaners
1586,32,38,43,113,75,fast learners
1587,47,19,33,99,66,Average learners
1588,24,30,43,97,64,Average learners
1589,42,43,33,118,78,fast learners
1590,15,26,36,77,51,Average learners
1591,48,11,26,85,56,Average learners
1592,40,45,23,108,72,fast learners
1593,49,33,49,131,87,fast learners
1594,19,36,49,104,69,Average learners
1595,41,46,38,125,83,fast learners
1596,34,49,43,126,84,fast learners
1597,21,34,19,74,49,slow leaners
1598,26,10,31,67,44,slow leaners
1599,28,24,41,93,62,Average learners
1600,17,40,16,73,48,slow leaners
1601,36,40,39,115,76,fast learners
1602,24,48,33,105,70,fast learners
1603,30,38,13,81,54,Average learners
1604,36,21,17,74,49,slow leaners
1605,32,12,39,83,55,Average learners
1606,16,46,32,94,62,Average learners
1607,41,44,23,108,72,fast learners
1608,44,26,47,117,78,fast learners
1609,35,38,20,93,62,Average learners
1610,39,21,11,71,47,slow leaners
1611,20,24,10,54,36,slow leaners
1612,10,15,31,56,37,slow leaners
1613,13,34,19,66,44,slow leaners
1614,26,43,25,94,62,Average learners
1615,35,41,25,101,67,Average learners
1616,36,20,11,67,44,slow leaners
1617,43,12,44,99,66,Average learners
1618,29,47,21,97,64,Average learners
1619,36,29,46,111,74,fast learners
1620,48,26,17,91,60,Average learners
1621,27,24,40,91,60,Average learners
1622,46,33,19,98,65,Average learners
1623,39,47,31,117,78,fast learners
1624,49,17,44,110,73,fast learners
1625,33,22,42,97,64,Average learners
1626,39,11,46,96,64,Average learners
1627,22,20,27,69,46,slow leaners
1628,18,31,38,87,58,Average learners
1629,43,41,10,94,62,Average learners
1630,18,10,36,64,42,slow leaners
1631,43,46,41,130,86,fast learners
1632,48,31,40,119,79,fast learners
1633,32,27,39,98,65,Average learners
1634,18,26,38,82,54,Average learners
1635,22,27,40,89,59,Average learners
1636,35,44,13,92,61,Average learners
1637,18,10,14,42,28,slow leaners
1638,42,13,41,96,64,Average learners
1639,26,32,28,86,57,Average learners
1640,22,11,17,50,33,slow leaners
1641,45,32,20,97,64,Average learners
1642,30,22,34,86,57,Average learners
1643,26,49,27,102,68,Average learners
1644,17,27,15,59,39,slow leaners
1645,41,13,35,89,59,Average learners
1646,27,49,32,108,72,fast learners
1647,32,41,15,88,58,Average learners
1648,25,45,49,119,79,fast learners
1649,41,13,46,100,66,Average learners
1650,25,27,20,72,48,slow leaners
1651,41,27,20,88,58,Average learners
1652,17,11,20,48,32,slow leaners
1653,10,34,27,71,47,slow leaners
1654,30,27,46,103,68,Average learners
1655,29,15,11,55,36,slow leaners
1656,31,21,42,94,62,Average learners
1657,10,29,46,85,56,Average learners
1658,45,18,27,90,60,Average learners
1659,18,10,44,72,48,slow leaners
1660,24,33,43,100,66,Average learners
1661,29,21,35,85,56,Average learners
1662,38,28,45,111,74,fast learners
1663,40,42,21,103,68,Average learners
1664,41,18,45,104,69,Average learners
1665,22,11,46,79,52,Average learners
1666,22,16,38,76,50,Average learners
1667,30,25,17,72,48,slow leaners
1668,17,32,29,78,52,Average learners
1669,14,36,19,69,46,slow leaners
1670,10,46,47,103,68,Average learners
1671,16,27,42,85,56,Average learners
1672,47,25,20,92,61,Average learners
1673,36,47,41,124,82,fast learners
1674,44,48,43,135,90,fast learners
1675,41,22,26,89,59,Average learners
1676,49,37,30,116,77,fast learners
1677,11,11,24,46,30,slow leaners
1678,43,18,31,92,61,Average learners
1679,45,11,27,83,55,Average learners
1680,40,35,48,123,82,fast learners
1681,41,46,20,107,71,fast learners
1682,41,41,18,100,66,Average learners
1683,31,31,26,88,58,Average learners
1684,39,31,16,86,57,Average learners
1685,42,39,44,125,83,fast learners
1686,15,19,21,55,36,slow leaners
1687,41,38,11,90,60,Average learners
1688,23,14,29,66,44,slow leaners
1689,23,36,31,90,60,Average learners
1690,25,16,41,82,54,Average learners
1691,39,31,14,84,56,Average learners
1692,28,22,22,72,48,slow leaners
1693,40,29,22,91,60,Average learners
1694,41,26,20,87,58,Average learners
1695,23,19,37,79,52,Average learners
1696,13,10,11,34,22,slow leaners
1697,11,34,46,91,60,Average learners
1698,30,14,17,61,40,slow leaners
1699,42,44,29,115,76,fast learners
1700,18,48,13,79,52,Average learners
1701,26,48,20,94,62,Average learners
1702,49,49,33,131,87,fast learners
1703,30,46,23,99,66,Average learners
1704,12,39,35,86,57,Average learners
1705,16,46,36,98,65,Average learners
1706,12,45,12,69,46,slow leaners
1707,15,22,23,60,40,slow leaners
1708,15,12,45,72,48,slow leaners
1709,34,23,22,79,52,Average learners
1710,10,25,21,56,37,slow leaners
1711,29,28,33,90,60,Average learners
1712,30,47,27,104,69,Average learners
1713,24,23,15,62,41,slow leaners
1714,42,41,32,115,76,fast learners
1715,24,11,26,61,40,slow leaners
1716,15,48,41,104,69,Average learners
1717,33,16,32,81,54,Average learners
1718,32,17,28,77,51,Average learners
1719,17,27,33,77,51,Average learners
1720,26,49,10,85,56,Average learners
1721,16,34,10,60,40,slow leaners
1722,49,37,14,100,66,Average learners
1723,44,49,18,111,74,fast learners
1724,15,46,38,99,66,Average learners
1725,47,28,35,110,73,fast learners
1726,11,42,40,93,62,Average learners
1727,23,46,19,88,58,Average learners
1728,47,27,18,92,61,Average learners
1729,45,45,47,137,91,fast learners
1730,14,32,23,69,46,slow leaners
1731,40,18,42,100,66,Average learners
1732,35,44,20,99,66,Average learners
1733,28,44,36,108,72,fast learners
1734,41,25,49,115,76,fast learners
1735,38,28,36,102,68,Average learners
1736,18,27,35,80,53,Average learners
1737,12,13,41,66,44,slow leaners
1738,40,32,47,119,79,fast learners
1739,32,38,27,97,64,Average learners
1740,35,13,47,95,63,Average learners
1741,27,14,26,67,44,slow leaners
1742,36,44,19,99,66,Average learners
1743,23,31,31,85,56,Average learners
1744,10,25,40,75,50,Average learners
1745,14,12,17,43,28,slow leaners
1746,45,33,18,96,64,Average learners
1747,45,44,33,122,81,fast learners
1748,39,10,26,75,50,Average learners
1749,12,40,41,93,62,Average learners
1750,24,11,38,73,48,slow leaners
1751,43,18,40,101,67,Average learners
1752,47,11,15,73,48,slow leaners
1753,15,14,12,41,27,slow leaners
1754,28,43,23,94,62,Average learners
1755,33,46,26,105,70,fast learners
1756,39,18,31,88,58,Average learners
1757,44,29,36,109,72,fast learners
1758,32,36,26,94,62,Average learners
1759,19,47,31,97,64,Average learners
1760,39,33,37,109,72,fast learners
1761,17,36,38,91,60,Average learners
1762,19,11,24,54,36,slow leaners
1763,46,40,25,111,74,fast learners
1764,11,35,13,59,39,slow leaners
1765,33,18,41,92,61,Average learners
1766,34,34,23,91,60,Average learners
1767,29,15,14,58,38,slow leaners
1768,43,12,37,92,61,Average learners
1769,34,15,33,82,54,Average learners
1770,10,14,31,55,36,slow leaners
1771,18,18,11,47,31,slow leaners
1772,46,49,31,126,84,fast learners
1773,39,33,13,85,56,Average learners
1774,18,22,24,64,42,slow leaners
1775,47,28,26,101,67,Average learners
1776,31,26,10,67,44,slow leaners
1777,15,23,41,79,52,Average learners
1778,18,29,27,74,49,slow leaners
1779,27,28,43,98,65,Average learners
1780,19,22,39,80,53,Average learners
1781,31,22,43,96,64,Average learners
1782,10,35,37,82,54,Average learners
1783,20,45,33,98,65,Average learners
1784,19,33,33,85,56,Average learners
1785,39,22,21,82,54,Average learners
1786,11,37,40,88,58,Average learners
1787,19,47,48,114,76,fast learners
1788,40,20,14,74,49,slow leaners
1789,40,14,29,83,55,Average learners
1790,17,46,27,90,60,Average learners
1791,45,16,35,96,64,Average learners
1792,30,24,35,89,59,Average learners
1793,39,30,31,100,66,Average learners
1794,24,20,12,56,37,slow leaners
1795,10,46,21,77,51,Average learners
1796,48,29,45,122,81,fast learners
1797,40,34,17,91,60,Average learners
1798,40,19,13,72,48,slow leaners
1799,34,21,44,99,66,Average learners
1800,34,39,18,91,60,Average learners
1801,30,16,45,91,60,Average learners
1802,22,47,10,79,52,Average learners
1803,44,20,41,105,70,fast learners
1804,43,44,28,115,76,fast learners
1805,20,15,31,66,44,slow leaners
1806,15,34,46,95,63,Average learners
1807,15,23,27,65,43,slow leaners
1808,27,45,12,84,56,Average learners
1809,33,47,31,111,74,fast learners
1810,11,31,17,59,39,slow leaners
1811,42,41,42,125,83,fast learners
1812,18,11,12,41,27,slow leaners
1813,11,20,49,80,53,Average learners
1814,24,11,47,82,54,Average learners
1815,16,40,12,68,45,slow leaners
1816,24,35,17,76,50,Average learners
1817,22,21,28,71,47,slow leaners
1818,44,30,21,95,63,Average learners
1819,36,29,33,98,65,Average learners
1820,17,29,43,89,59,Average learners
1821,32,30,29,91,60,Average learners
1822,21,45,15,81,54,Average learners
1823,38,15,43,96,64,Average learners
1824,12,43,37,92,61,Average learners
1825,32,32,17,81,54,Average learners
1826,30,45,48,123,82,fast learners
1827,15,35,33,83,55,Average learners
1828,25,37,13,75,50,Average learners
1829,39,33,31,103,68,Average learners
1830,32,10,21,63,42,slow leaners
1831,45,33,45,123,82,fast learners
1832,29,48,11,88,58,Average learners
1833,37,34,24,95,63,Average learners
1834,19,26,43,88,58,Average learners
1835,41,26,13,80,53,Average learners
1836,16,33,19,68,45,slow leaners
1837,12,10,25,47,31,slow leaners
1838,23,19,27,69,46,slow leaners
1839,45,38,19,102,68,Average learners
1840,25,46,43,114,76,fast learners
1841,30,40,22,92,61,Average learners
1842,33,31,21,85,56,Average learners
1843,45,29,35,109,72,fast learners
1844,19,42,27,88,58,Average learners
1845,23,29,19,71,47,slow leaners
1846,45,15,11,71,47,slow leaners
1847,23,13,20,56,37,slow leaners
1848,39,45,43,127,84,fast learners
1849,38,30,34,102,68,Average learners
1850,25,43,17,85,56,Average learners
1851,11,25,35,71,47,slow leaners
1852,20,27,38,85,56,Average learners
1853,47,42,44,133,88,fast learners
1854,43,45,38,126,84,fast learners
1855,22,13,37,72,48,slow leaners
1856,48,47,49,144,96,fast learners
1857,38,37,12,87,58,Average learners
1858,12,40,34,86,57,Average learners
1859,31,11,45,87,58,Average learners
1860,45,11,33,89,59,Average learners
1861,46,15,10,71,47,slow leaners
1862,37,15,47,99,66,Average learners
1863,17,14,32,63,42,slow leaners
1864,35,25,32,92,61,Average learners
1865,20,35,26,81,54,Average learners
1866,31,21,23,75,50,Average learners
1867,21,38,13,72,48,slow leaners
1868,39,17,38,94,62,Average learners
1869,17,47,36,100,66,Average learners
1870,25,36,13,74,49,slow leaners
1871,43,40,30,113,75,fast learners
1872,38,27,12,77,51,Average learners
1873,28,34,43,105,70,fast learners
1874,26,17,47,90,60,Average learners
1875,35,24,25,84,56,Average learners
1876,33,18,21,72,48,slow leaners
1877,43,11,29,83,55,Average learners
1878,42,23,41,106,70,fast learners
1879,12,32,36,80,53,Average learners
1880,15,32,31,78,52,Average learners
1881,22,20,34,76,50,Average learners
1882,21,35,31,87,58,Average learners
1883,22,42,47,111,74,fast learners
1884,14,38,20,72,48,slow leaners
1885,44,31,32,107,71,fast learners
1886,35,32,16,83,55,Average learners
1887,20,28,42,90,60,Average learners
1888,43,17,24,84,56,Average learners
1889,36,11,30,77,51,Average learners
1890,20,49,15,84,56,Average learners
1891,17,39,24,80,53,Average learners
1892,25,49,15,89,59,Average learners
1893,31,15,35,81,54,Average learners
1894,45,44,31,120,80,fast learners
1895,26,16,37,79,52,Average learners
1896,44,37,43,124,82,fast learners
1897,16,32,31,79,52,Average learners
1898,42,33,15,90,60,Average learners
1899,45,24,29,98,65,Average learners
1900,30,12,14,56,37,slow leaners
1901,34,15,48,97,64,Average learners
1902,41,32,39,112,74,fast learners
1903,47,12,49,108,72,fast learners
1904,42,46,25,113,75,fast learners
1905,47,13,14,74,49,slow leaners
1906,35,16,17,68,45,slow leaners
1907,26,17,19,62,41,slow leaners
1908,34,30,27,91,60,Average learners
1909,20,29,14,63,42,slow leaners
1910,23,41,42,106,70,fast learners
1911,24,41,41,106,70,fast learners
1912,47,26,29,102,68,Average learners
1913,20,29,31,80,53,Average learners
1914,38,15,20,73,48,slow leaners
1915,31,42,26,99,66,Average learners
1916,15,42,26,83,55,Average learners
1917,20,33,23,76,50,Average learners
1918,48,23,49,120,80,fast learners
1919,41,40,31,112,74,fast learners
1920,25,44,48,117,78,fast learners
1921,12,37,11,60,40,slow leaners
1922,22,38,33,93,62,Average learners
1923,49,30,34,113,75,fast learners
1924,21,27,23,71,47,slow leaners
1925,29,24,19,72,48,slow leaners
1926,28,42,47,117,78,fast learners
1927,28,27,16,71,47,slow leaners
1928,46,11,40,97,64,Average learners
1929,17,26,12,55,36,slow leaners
1930,24,29,45,98,65,Average learners
1931,34,15,28,77,51,Average learners
1932,36,41,42,119,79,fast learners
1933,22,26,21,69,46,slow leaners
1934,17,42,32,91,60,Average learners
1935,14,48,36,98,65,Average learners
1936,22,36,41,99,66,Average learners
1937,41,43,23,107,71,fast learners
1938,32,21,24,77,51,Average learners
1939,19,45,43,107,71,fast learners
1940,13,18,38,69,46,slow leaners
1941,41,33,44,118,78,fast learners
1942,34,22,41,97,64,Average learners
1943,30,33,33,96,64,Average learners
1944,49,33,14,96,64,Average learners
1945,13,21,34,68,45,slow leaners
1946,23,33,47,103,68,Average learners
1947,49,37,25,111,74,fast learners
1948,33,33,46,112,74,fast learners
1949,22,44,42,108,72,fast learners
1950,10,20,11,41,27,slow leaners
1951,20,42,23,85,56,Average learners
1952,16,18,36,70,46,slow leaners
1953,14,11,39,64,42,slow leaners
1954,36,37,39,112,74,fast learners
1955,33,26,30,89,59,Average learners
1956,44,38,36,118,78,fast learners
1957,21,12,44,77,51,Average learners
1958,15,31,33,79,52,Average learners
1959,36,26,34,96,64,Average learners
1960,19,18,18,55,36,slow leaners
1961,21,30,48,99,66,Average learners
1962,28,12,19,59,39,slow leaners
1963,47,20,42,109,72,fast learners
1964,14,29,31,74,49,slow leaners
1965,17,41,41,99,66,Average learners
1966,23,31,11,65,43,slow leaners
1967,24,45,23,92,61,Average learners
1968,17,14,26,57,38,slow leaners
1969,39,49,21,109,72,fast learners
1970,19,31,27,77,51,Average learners
1971,19,45,21,85,56,Average learners
1972,37,47,26,110,73,fast learners
1973,25,31,13,69,46,slow leaners
1974,25,42,13,80,53,Average learners
1975,19,46,17,82,54,Average learners
1976,11,35,34,80,53,Average learners
1977,24,12,25,61,40,slow leaners
1978,13,19,48,80,53,Average learners
1979,32,24,31,87,58,Average learners
1980,32,49,34,115,76,fast learners
1981,33,30,18,81,54,Average learners
1982,28,42,14,84,56,Average learners
1983,13,17,45,75,50,Average learners
1984,38,31,11,80,53,Average learners
1985,48,32,13,93,62,Average learners
1986,47,33,30,110,73,fast learners
1987,16,45,39,100,66,Average learners
1988,19,33,36,88,58,Average learners
1989,44,20,20,84,56,Average learners
1990,48,18,38,104,69,Average learners
1991,36,22,33,91,60,Average learners
1992,23,35,10,68,45,slow leaners
1993,27,48,11,86,57,Average learners
1994,35,25,46,106,70,fast learners
1995,43,29,16,88,58,Average learners
1996,25,35,40,100,66,Average learners
1997,15,21,21,57,38,slow leaners
1998,17,32,33,82,54,Average learners
1999,44,37,11,92,61,Average learners
2000,30,39,25,94,62,Average learners
2001,26,22,30,78,52,Average learners
2002,11,48,23,82,54,Average learners
2003,15,49,16,80,53,Average learners
2004,34,36,17,87,58,Average learners
2005,27,28,13,68,45,slow leaners
2006,18,41,13,72,48,slow leaners
2007,39,26,47,112,74,fast learners
2008,48,24,49,121,80,fast learners
2009,32,32,42,106,70,fast learners
2010,43,17,45,105,70,fast learners
2011,10,29,48,87,58,Average learners
2012,18,30,30,78,52,Average learners
2013,49,10,16,75,50,Average learners
2014,24,28,36,88,58,Average learners
2015,13,36,34,83,55,Average learners
2016,11,46,33,90,60,Average learners
2017,43,43,24,110,73,fast learners
2018,27,43,22,92,61,Average learners
2019,46,28,44,118,78,fast learners
2020,23,18,46,87,58,Average learners
2021,42,27,37,106,70,fast learners
2022,13,34,32,79,52,Average learners
2023,31,38,12,81,54,Average learners
2024,37,10,10,57,38,slow leaners
2025,44,19,29,92,61,Average learners
2026,38,41,23,102,68,Average learners
2027,14,31,31,76,50,Average learners
2028,30,38,43,111,74,fast learners
2029,25,45,17,87,58,Average learners
2030,24,37,44,105,70,fast learners
2031,33,41,32,106,70,fast learners
2032,38,21,35,94,62,Average learners
2033,45,37,43,125,83,fast learners
2034,18,46,22,86,57,Average learners
2035,22,12,46,80,53,Average learners
2036,20,10,26,56,37,slow leaners
2037,21,17,10,48,32,slow leaners
2038,48,28,35,111,74,fast learners
2039,41,14,38,93,62,Average learners
2040,44,20,28,92,61,Average learners
2041,43,20,17,80,53,Average learners
2042,10,15,45,70,46,slow leaners
2043,41,39,18,98,65,Average learners
2044,29,44,33,106,70,fast learners
2045,27,38,25,90,60,Average learners
2046,34,34,46,114,76,fast learners
2047,41,22,19,82,54,Average learners
2048,41,10,28,79,52,Average learners
2049,19,48,18,85,56,Average learners
2050,19,27,21,67,44,slow leaners
2051,41,45,12,98,65,Average learners
2052,15,11,32,58,38,slow leaners
2053,25,38,36,99,66,Average learners
2054,48,20,21,89,59,Average learners
2055,33,32,13,78,52,Average learners
2056,23,14,10,47,31,slow leaners
2057,31,47,27,105,70,fast learners
2058,12,49,29,90,60,Average learners
2059,29,41,45,115,76,fast learners
2060,16,36,38,90,60,Average learners
2061,44,18,42,104,69,Average learners
2062,21,18,17,56,37,slow leaners
2063,23,26,49,98,65,Average learners
2064,30,38,18,86,57,Average learners
2065,35,27,31,93,62,Average learners
2066,19,22,48,89,59,Average learners
2067,32,48,24,104,69,Average learners
2068,47,16,24,87,58,Average learners
2069,37,37,46,120,80,fast learners
2070,21,21,10,52,34,slow leaners
2071,37,19,15,71,47,slow leaners
2072,31,10,34,75,50,Average learners
2073,23,32,22,77,51,Average learners
2074,27,23,23,73,48,slow leaners
2075,36,37,38,111,74,fast learners
2076,45,24,34,103,68,Average learners
2077,44,45,44,133,88,fast learners
2078,10,11,23,44,29,slow leaners
2079,36,15,12,63,42,slow leaners
2080,46,25,27,98,65,Average learners
2081,40,47,41,128,85,fast learners
2082,28,38,29,95,63,Average learners
2083,10,49,47,106,70,fast learners
2084,36,25,14,75,50,Average learners
2085,24,23,12,59,39,slow leaners
2086,13,31,14,58,38,slow leaners
2087,12,11,24,47,31,slow leaners
2088,16,31,30,77,51,Average learners
2089,24,31,38,93,62,Average learners
2090,25,40,23,88,58,Average learners
2091,15,49,42,106,70,fast learners
2092,16,18,46,80,53,Average learners
2093,38,47,44,129,86,fast learners
2094,44,10,48,102,68,Average learners
2095,46,34,14,94,62,Average learners
2096,13,37,39,89,59,Average learners
2097,49,30,47,126,84,fast learners
2098,20,43,39,102,68,Average learners
2099,10,44,14,68,45,slow leaners
2100,31,19,46,96,64,Average learners
2101,17,31,21,69,46,slow leaners
2102,43,42,34,119,79,fast learners
2103,29,21,21,71,47,slow leaners
2104,33,32,10,75,50,Average learners
2105,35,46,36,117,78,fast learners
2106,10,40,28,78,52,Average learners
2107,32,19,37,88,58,Average learners
2108,29,27,18,74,49,slow leaners
2109,39,31,11,81,54,Average learners
2110,40,38,22,100,66,Average learners
2111,30,24,48,102,68,Average learners
2112,42,44,10,96,64,Average learners
2113,35,37,40,112,74,fast learners
2114,16,25,38,79,52,Average learners
2115,43,36,47,126,84,fast learners
2116,37,16,34,87,58,Average learners
2117,43,17,10,70,46,slow leaners
2118,17,44,47,108,72,fast learners
2119,13,16,20,49,32,slow leaners
2120,36,45,30,111,74,fast learners
2121,19,27,15,61,40,slow leaners
2122,35,49,14,98,65,Average learners
2123,43,46,17,106,70,fast learners
2124,48,24,42,114,76,fast learners
2125,30,33,21,84,56,Average learners
2126,24,45,37,106,70,fast learners
2127,16,30,47,93,62,Average learners
2128,29,40,21,90,60,Average learners
2129,27,49,10,86,57,Average learners
2130,30,41,10,81,54,Average learners
2131,33,48,18,99,66,Average learners
2132,12,46,26,84,56,Average learners
2133,26,21,44,91,60,Average learners
2134,36,11,48,95,63,Average learners
2135,30,46,48,124,82,fast learners
2136,22,32,44,98,65,Average learners
2137,40,37,16,93,62,Average learners
2138,37,48,24,109,72,fast learners
2139,17,10,29,56,37,slow leaners
2140,27,31,26,84,56,Average learners
2141,26,41,11,78,52,Average learners
2142,12,34,41,87,58,Average learners
2143,30,19,11,60,40,slow leaners
2144,31,28,14,73,48,slow leaners
2145,44,42,31,117,78,fast learners
2146,40,26,24,90,60,Average learners
2147,35,32,37,104,69,Average learners
2148,40,34,14,88,58,Average learners
2149,29,38,24,91,60,Average learners
2150,32,17,16,65,43,slow leaners
2151,32,22,49,103,68,Average learners
2152,27,29,45,101,67,Average learners
2153,35,27,40,102,68,Average learners
2154,41,18,28,87,58,Average learners
2155,22,39,21,82,54,Average learners
2156,37,14,34,85,56,Average learners
2157,39,28,17,84,56,Average learners
2158,12,38,15,65,43,slow leaners
2159,24,47,32,103,68,Average learners
2160,41,34,30,105,70,fast learners
2161,44,14,28,86,57,Average learners
2162,17,36,35,88,58,Average learners
2163,40,30,11,81,54,Average learners
2164,22,24,48,94,62,Average learners
2165,27,42,16,85,56,Average learners
2166,24,44,29,97,64,Average learners
2167,48,14,20,82,54,Average learners
2168,12,33,23,68,45,slow leaners
2169,46,38,23,107,71,fast learners
2170,12,26,42,80,53,Average learners
2171,17,23,19,59,39,slow leaners
2172,43,30,39,112,74,fast learners
2173,12,32,43,87,58,Average learners
2174,47,36,21,104,69,Average learners
2175,40,13,16,69,46,slow leaners
2176,15,16,14,45,30,slow leaners
2177,10,19,28,57,38,slow leaners
2178,43,12,44,99,66,Average learners
2179,10,49,27,86,57,Average learners
2180,19,17,43,79,52,Average learners
2181,30,28,16,74,49,slow leaners
2182,40,45,12,97,64,Average learners
2183,17,12,26,55,36,slow leaners
2184,49,26,21,96,64,Average learners
2185,34,30,16,80,53,Average learners
2186,23,14,16,53,35,slow leaners
2187,26,48,41,115,76,fast learners
2188,32,39,25,96,64,Average learners
2189,38,26,27,91,60,Average learners
2190,21,16,27,64,42,slow leaners
2191,18,42,45,105,70,fast learners
2192,35,14,22,71,47,slow leaners
2193,25,12,20,57,38,slow leaners
2194,32,46,18,96,64,Average learners
2195,44,33,49,126,84,fast learners
2196,42,45,35,122,81,fast learners
2197,33,43,12,88,58,Average learners
2198,13,19,14,46,30,slow leaners
2199,15,35,39,89,59,Average learners
2200,29,35,37,101,67,Average learners
2201,39,24,21,84,56,Average learners
2202,47,26,43,116,77,fast learners
2203,25,14,38,77,51,Average learners
2204,10,42,29,81,54,Average learners
2205,34,32,45,111,74,fast learners
2206,44,49,14,107,71,fast learners
2207,15,49,47,111,74,fast learners
2208,34,26,47,107,71,fast learners
2209,35,26,26,87,58,Average learners
2210,45,33,23,101,67,Average learners
2211,38,12,36,86,57,Average learners
2212,40,15,19,74,49,slow leaners
2213,32,31,43,106,70,fast learners
2214,13,42,19,74,49,slow leaners
2215,47,27,49,123,82,fast learners
2216,31,41,15,87,58,Average learners
2217,39,16,21,76,50,Average learners
2218,20,45,38,103,68,Average learners
2219,31,21,41,93,62,Average learners
2220,45,26,27,98,65,Average learners
2221,29,42,14,85,56,Average learners
2222,27,39,49,115,76,fast learners
2223,19,27,20,66,44,slow leaners
2224,44,41,30,115,76,fast learners
2225,37,26,28,91,60,Average learners
2226,16,23,39,78,52,Average learners
2227,35,34,32,101,67,Average learners
2228,45,32,40,117,78,fast learners
2229,28,13,12,53,35,slow leaners
2230,45,39,14,98,65,Average learners
2231,26,20,46,92,61,Average learners
2232,32,44,28,104,69,Average learners
2233,21,45,24,90,60,Average learners
2234,44,36,25,105,70,fast learners
2235,33,18,46,97,64,Average learners
2236,20,35,28,83,55,Average learners
2237,32,18,24,74,49,slow leaners
2238,35,21,34,90,60,Average learners
2239,39,29,23,91,60,Average learners
2240,19,14,26,59,39,slow leaners
2241,38,34,15,87,58,Average learners
2242,23,38,17,78,52,Average learners
2243,29,16,42,87,58,Average learners
2244,29,35,24,88,58,Average learners
2245,24,21,41,86,57,Average learners
2246,25,10,49,84,56,Average learners
2247,26,17,26,69,46,slow leaners
2248,48,14,40,102,68,Average learners
2249,29,29,40,98,65,Average learners
2250,43,38,28,109,72,fast learners
2251,48,49,35,132,88,fast learners
2252,17,12,30,59,39,slow leaners
2253,12,12,43,67,44,slow leaners
2254,36,26,11,73,48,slow leaners
2255,43,19,31,93,62,Average learners
2256,42,39,12,93,62,Average learners
2257,36,13,16,65,43,slow leaners
2258,47,37,28,112,74,fast learners
2259,42,43,49,134,89,fast learners
2260,35,20,18,73,48,slow leaners
2261,15,45,15,75,50,Average learners
2262,14,30,40,84,56,Average learners
2263,32,44,26,102,68,Average learners
2264,27,21,47,95,63,Average learners
2265,27,27,37,91,60,Average learners
2266,27,21,21,69,46,slow leaners
2267,34,48,17,99,66,Average learners
2268,13,18,17,48,32,slow leaners
2269,26,26,39,91,60,Average learners
2270,47,48,44,139,92,fast learners
2271,18,27,25,70,46,slow leaners
2272,21,15,18,54,36,slow leaners
2273,26,43,28,97,64,Average learners
2274,11,43,46,100,66,Average learners
2275,16,23,36,75,50,Average learners
2276,25,22,46,93,62,Average learners
2277,37,13,32,82,54,Average learners
2278,18,30,27,75,50,Average learners
2279,30,31,17,78,52,Average learners
2280,14,32,14,60,40,slow leaners
2281,39,45,27,111,74,fast learners
2282,16,29,27,72,48,slow leaners
2283,30,43,40,113,75,fast learners
2284,30,22,15,67,44,slow leaners
2285,20,10,44,74,49,slow leaners
2286,29,19,37,85,56,Average learners
2287,21,33,27,81,54,Average learners
2288,41,30,44,115,76,fast learners
2289,41,15,35,91,60,Average learners
2290,15,12,18,45,30,slow leaners
2291,22,36,46,104,69,Average learners
2292,14,25,24,63,42,slow leaners
2293,22,12,13,47,31,slow leaners
2294,13,39,42,94,62,Average learners
2295,22,20,18,60,40,slow leaners
2296,28,23,11,62,41,slow leaners
2297,44,46,25,115,76,fast learners
2298,36,31,36,103,68,Average learners
2299,48,49,20,117,78,fast learners
2300,35,29,44,108,72,fast learners
2301,14,10,17,41,27,slow leaners
2302,26,35,28,89,59,Average learners
2303,24,10,39,73,48,slow leaners
2304,11,33,41,85,56,Average learners
2305,13,39,24,76,50,Average learners
2306,24,18,31,73,48,slow leaners
2307,27,25,17,69,46,slow leaners
2308,43,43,26,112,74,fast learners
2309,42,13,19,74,49,slow leaners
2310,21,35,18,74,49,slow leaners
2311,18,33,19,70,46,slow leaners
2312,22,18,15,55,36,slow leaners
2313,10,28,35,73,48,slow leaners
2314,47,13,32,92,61,Average learners
2315,26,32,49,107,71,fast learners
2316,15,21,42,78,52,Average learners
2317,20,35,28,83,55,Average learners
2318,26,38,35,99,66,Average learners
2319,20,21,49,90,60,Average learners
2320,19,47,36,102,68,Average learners
2321,38,18,12,68,45,slow leaners
2322,12,33,27,72,48,slow leaners
2323,43,39,40,122,81,fast learners
2324,32,13,23,68,45,slow leaners
2325,33,22,18,73,48,slow leaners
2326,30,38,32,100,66,Average learners
2327,21,26,11,58,38,slow leaners
2328,17,29,30,76,50,Average learners
2329,29,11,14,54,36,slow leaners
2330,39,11,17,67,44,slow leaners
2331,15,35,15,65,43,slow leaners
2332,31,35,38,104,69,Average learners
2333,10,46,33,89,59,Average learners
2334,29,18,41,88,58,Average learners
2335,34,23,21,78,52,Average learners
2336,21,36,13,70,46,slow leaners
2337,11,27,15,53,35,slow leaners
2338,18,48,26,92,61,Average learners
2339,16,16,23,55,36,slow leaners
2340,40,40,19,99,66,Average learners
2341,32,13,43,88,58,Average learners
2342,24,27,33,84,56,Average learners
2343,36,12,39,87,58,Average learners
2344,12,30,22,64,42,slow leaners
2345,47,38,34,119,79,fast learners
2346,13,20,32,65,43,slow leaners
2347,38,37,11,86,57,Average learners
2348,46,25,45,116,77,fast learners
2349,43,27,41,111,74,fast learners
2350,45,39,34,118,78,fast learners
2351,14,43,33,90,60,Average learners
2352,37,11,41,89,59,Average learners
2353,31,44,24,99,66,Average learners
2354,35,23,45,103,68,Average learners
2355,14,19,11,44,29,slow leaners
2356,24,18,49,91,60,Average learners
2357,44,39,22,105,70,fast learners
2358,21,21,32,74,49,slow leaners
2359,27,49,49,125,83,fast learners
2360,25,37,22,84,56,Average learners
2361,20,23,46,89,59,Average learners
2362,30,37,46,113,75,fast learners
2363,27,46,36,109,72,fast learners
2364,11,43,10,64,42,slow leaners
2365,19,33,44,96,64,Average learners
2366,27,14,30,71,47,slow leaners
2367,41,39,10,90,60,Average learners
2368,44,15,44,103,68,Average learners
2369,45,19,24,88,58,Average learners
2370,22,10,37,69,46,slow leaners
2371,15,16,42,73,48,slow leaners
2372,43,13,23,79,52,Average learners
2373,21,47,21,89,59,Average learners
2374,11,12,26,49,32,slow leaners
2375,49,15,43,107,71,fast learners
2376,22,34,49,105,70,fast learners
2377,22,13,26,61,40,slow leaners
2378,44,43,45,132,88,fast learners
2379,10,16,39,65,43,slow leaners
2380,14,13,32,59,39,slow leaners
2381,29,46,23,98,65,Average learners
2382,28,35,26,89,59,Average learners
2383,12,27,36,75,50,Average learners
2384,25,39,22,86,57,Average learners
2385,34,26,34,94,62,Average learners
2386,49,22,43,114,76,fast learners
2387,40,14,42,96,64,Average learners
2388,24,20,16,60,40,slow leaners
2389,37,21,30,88,58,Average learners
2390,41,22,44,107,71,fast learners
2391,36,29,16,81,54,Average learners
2392,39,35,32,106,70,fast learners
2393,37,32,24,93,62,Average learners
2394,15,31,43,89,59,Average learners
2395,10,13,25,48,32,slow leaners
2396,42,40,30,112,74,fast learners
2397,44,13,12,69,46,slow leaners
2398,28,27,15,70,46,slow leaners
2399,46,16,18,80,53,Average learners
2400,43,47,40,130,86,fast learners
2401,32,39,37,108,72,fast learners
2402,41,47,44,132,88,fast learners
2403,22,19,49,90,60,Average learners
2404,21,28,34,83,55,Average learners
2405,34,13,30,77,51,Average learners
2406,27,11,11,49,32,slow leaners
2407,22,20,10,52,34,slow leaners
2408,13,40,22,75,50,Average learners
2409,32,22,30,84,56,Average learners
2410,16,33,40,89,59,Average learners
2411,37,49,19,105,70,fast learners
2412,36,38,14,88,58,Average learners
2413,40,25,35,100,66,Average learners
2414,21,45,10,76,50,Average learners
2415,27,31,34,92,61,Average learners
2416,13,24,12,49,32,slow leaners
2417,17,36,48,101,67,Average learners
2418,23,36,26,85,56,Average learners
2419,47,36,37,120,80,fast learners
2420,27,34,39,100,66,Average learners
2421,13,46,16,75,50,Average learners
2422,39,17,29,85,56,Average learners
2423,13,49,42,104,69,Average learners
2424,31,23,29,83,55,Average learners
2425,16,47,43,106,70,fast learners
2426,21,13,13,47,31,slow leaners
2427,25,19,30,74,49,slow leaners
2428,24,26,38,88,58,Average learners
2429,39,38,24,101,67,Average learners
2430,27,12,36,75,50,Average learners
2431,39,38,42,119,79,fast learners
2432,36,22,29,87,58,Average learners
2433,22,20,10,52,34,slow leaners
2434,38,49,22,109,72,fast learners
2435,23,32,13,68,45,slow leaners
2436,46,22,11,79,52,Average learners
2437,49,49,42,140,93,fast learners
2438,31,41,41,113,75,fast learners
2439,43,24,20,87,58,Average learners
2440,24,24,33,81,54,Average learners
2441,33,46,22,101,67,Average learners
2442,46,11,44,101,67,Average learners
2443,25,43,41,109,72,fast learners
2444,20,32,49,101,67,Average learners
2445,13,31,32,76,50,Average learners
2446,32,15,29,76,50,Average learners
2447,48,46,25,119,79,fast learners
2448,40,31,27,98,65,Average learners
2449,23,46,18,87,58,Average learners
2450,43,11,22,76,50,Average learners
2451,26,28,40,94,62,Average learners
2452,33,35,29,97,64,Average learners
2453,34,25,34,93,62,Average learners
2454,16,30,25,71,47,slow leaners
2455,20,31,27,78,52,Average learners
2456,39,30,21,90,60,Average learners
2457,45,35,39,119,79,fast learners
2458,26,22,44,92,61,Average learners
2459,23,45,48,116,77,fast learners
2460,37,23,24,84,56,Average learners
2461,12,15,47,74,49,slow leaners
2462,46,19,31,96,64,Average learners
2463,15,17,43,75,50,Average learners
2464,43,47,29,119,79,fast learners
2465,40,41,21,102,68,Average learners
2466,38,32,48,118,78,fast learners
2467,10,48,32,90,60,Average learners
2468,35,31,15,81,54,Average learners
2469,16,31,42,89,59,Average learners
2470,38,15,14,67,44,slow leaners
2471,43,29,24,96,64,Average learners
2472,20,21,34,75,50,Average learners
2473,41,40,47,128,85,fast learners
2474,33,42,15,90,60,Average learners
2475,38,15,34,87,58,Average learners
2476,11,21,23,55,36,slow leaners
2477,39,19,29,87,58,Average learners
2478,18,32,29,79,52,Average learners
2479,13,46,22,81,54,Average learners
2480,42,47,17,106,70,fast learners
2481,30,48,30,108,72,fast learners
2482,27,14,31,72,48,slow leaners
2483,34,29,44,107,71,fast learners
2484,40,37,30,107,71,fast learners
2485,38,20,35,93,62,Average learners
2486,21,25,32,78,52,Average learners
2487,37,10,18,65,43,slow leaners
2488,31,33,34,98,65,Average learners
2489,45,42,43,130,86,fast learners
2490,22,21,20,63,42,slow leaners
2491,27,40,16,83,55,Average learners
2492,48,41,46,135,90,fast learners
2493,45,48,13,106,70,fast learners
2494,16,31,27,74,49,slow leaners
2495,16,32,30,78,52,Average learners
2496,17,22,21,60,40,slow leaners
2497,24,49,49,122,81,fast learners
2498,32,36,19,87,58,Average learners
2499,17,19,32,68,45,slow leaners
2500,27,26,47,100,66,Average learners
2501,25,43,36,104,69,Average learners
2502,48,42,10,100,66,Average learners
2503,19,39,29,87,58,Average learners
2504,37,34,28,99,66,Average learners
2505,11,19,12,42,28,slow leaners
2506,21,25,46,92,61,Average learners
2507,44,24,42,110,73,fast learners
2508,11,45,32,88,58,Average learners
2509,13,27,36,76,50,Average learners
2510,49,18,11,78,52,Average learners
2511,40,41,48,129,86,fast learners
2512,29,34,20,83,55,Average learners
2513,13,33,34,80,53,Average learners
2514,28,14,14,56,37,slow leaners
2515,20,40,46,106,70,fast learners
2516,28,30,14,72,48,slow leaners
2517,48,36,35,119,79,fast learners
2518,43,32,30,105,70,fast learners
2519,28,13,22,63,42,slow leaners
2520,22,12,22,56,37,slow leaners
2521,14,24,11,49,32,slow leaners
2522,45,13,20,78,52,Average learners
2523,19,18,16,53,35,slow leaners
2524,23,10,23,56,37,slow leaners
2525,35,29,26,90,60,Average learners
2526,44,25,43,112,74,fast learners
2527,10,45,31,86,57,Average learners
2528,38,48,13,99,66,Average learners
2529,36,44,21,101,67,Average learners
2530,49,28,41,118,78,fast learners
2531,21,15,12,48,32,slow leaners
2532,44,46,36,126,84,fast learners
2533,49,38,27,114,76,fast learners
2534,42,22,37,101,67,Average learners
2535,48,38,36,122,81,fast learners
2536,33,11,23,67,44,slow leaners
2537,22,27,39,88,58,Average learners
2538,39,46,14,99,66,Average learners
2539,27,31,47,105,70,fast learners
2540,21,49,15,85,56,Average learners
2541,24,29,34,87,58,Average learners
2542,10,38,37,85,56,Average learners
2543,48,39,38,125,83,fast learners
2544,40,19,22,81,54,Average learners
2545,29,29,31,89,59,Average learners
2546,48,24,30,102,68,Average learners
2547,37,10,18,65,43,slow leaners
2548,39,29,11,79,52,Average learners
2549,39,23,40,102,68,Average learners
2550,35,18,15,68,45,slow leaners
2551,21,22,36,79,52,Average learners
2552,33,15,18,66,44,slow leaners
2553,18,41,39,98,65,Average learners
2554,45,43,44,132,88,fast learners
2555,19,35,13,67,44,slow leaners
2556,17,16,29,62,41,slow leaners
2557,12,14,21,47,31,slow leaners
2558,13,30,33,76,50,Average learners
2559,17,25,38,80,53,Average learners
2560,47,42,27,116,77,fast learners
2561,42,33,35,110,73,fast learners
2562,15,17,32,64,42,slow leaners
2563,39,30,35,104,69,Average learners
2564,44,17,16,77,51,Average learners
2565,16,34,10,60,40,slow leaners
2566,31,27,42,100,66,Average learners
2567,26,11,21,58,38,slow leaners
2568,32,32,40,104,69,Average learners
2569,25,47,15,87,58,Average learners
2570,45,42,34,121,80,fast learners
2571,30,44,14,88,58,Average learners
2572,36,33,20,89,59,Average learners
2573,32,48,13,93,62,Average learners
2574,20,11,39,70,46,slow leaners
2575,25,31,18,74,49,slow leaners
2576,30,20,41,91,60,Average learners
2577,46,25,17,88,58,Average learners
2578,33,40,43,116,77,fast learners
2579,36,39,24,99,66,Average learners
2580,32,34,44,110,73,fast learners
2581,16,21,21,58,38,slow leaners
2582,48,24,10,82,54,Average learners
2583,45,37,18,100,66,Average learners
2584,11,34,35,80,53,Average learners
2585,43,15,38,96,64,Average learners
2586,14,20,27,61,40,slow leaners
2587,17,18,19,54,36,slow leaners
2588,39,49,29,117,78,fast learners
2589,42,25,31,98,65,Average learners
2590,47,44,10,101,67,Average learners
2591,31,11,21,63,42,slow leaners
2592,28,46,10,84,56,Average learners
2593,36,15,24,75,50,Average learners
2594,37,18,44,99,66,Average learners
2595,35,37,15,87,58,Average learners
2596,42,47,35,124,82,fast learners
2597,20,27,27,74,49,slow leaners
2598,34,25,17,76,50,Average learners
2599,34,17,37,88,58,Average learners
2600,17,34,24,75,50,Average learners
2601,11,17,44,72,48,slow leaners
2602,42,34,39,115,76,fast learners
2603,26,11,35,72,48,slow leaners
2604,23,47,20,90,60,Average learners
2605,24,19,38,81,54,Average learners
2606,22,47,29,98,65,Average learners
2607,37,31,29,97,64,Average learners
2608,16,45,48,109,72,fast learners
2609,44,18,11,73,48,slow leaners
2610,15,33,40,88,58,Average learners
2611,46,23,18,87,58,Average learners
2612,32,47,35,114,76,fast learners
2613,44,15,45,104,69,Average learners
2614,31,39,43,113,75,fast learners
2615,46,25,11,82,54,Average learners
2616,37,37,14,88,58,Average learners
2617,18,26,42,86,57,Average learners
2618,35,11,13,59,39,slow leaners
2619,36,14,30,80,53,Average learners
2620,34,48,45,127,84,fast learners
2621,24,43,31,98,65,Average learners
2622,17,42,26,85,56,Average learners
2623,31,40,12,83,55,Average learners
2624,37,28,31,96,64,Average learners
2625,30,16,35,81,54,Average learners
2626,39,29,32,100,66,Average learners
2627,23,46,35,104,69,Average learners
2628,45,37,36,118,78,fast learners
2629,30,48,28,106,70,fast learners
2630,10,39,35,84,56,Average learners
2631,24,17,35,76,50,Average learners
2632,10,37,49,96,64,Average learners
2633,44,36,44,124,82,fast learners
2634,37,13,22,72,48,slow leaners
2635,24,11,14,49,32,slow leaners
2636,25,42,49,116,77,fast learners
2637,43,31,32,106,70,fast learners
2638,40,18,31,89,59,Average learners
2639,29,34,47,110,73,fast learners
2640,30,36,31,97,64,Average learners
2641,42,35,14,91,60,Average learners
2642,20,25,10,55,36,slow leaners
2643,20,29,44,93,62,Average learners
2644,39,42,39,120,80,fast learners
2645,16,17,44,77,51,Average learners
2646,26,48,36,110,73,fast learners
2647,42,45,33,120,80,fast learners
2648,26,29,15,70,46,slow leaners
2649,11,43,46,100,66,Average learners
2650,47,21,13,81,54,Average learners
2651,31,11,36,78,52,Average learners
2652,24,35,38,97,64,Average learners
2653,16,38,28,82,54,Average learners
2654,49,10,29,88,58,Average learners
2655,28,10,16,54,36,slow leaners
2656,25,28,39,92,61,Average learners
2657,16,29,45,90,60,Average learners
2658,40,21,31,92,61,Average learners
2659,35,44,31,110,73,fast learners
2660,36,17,46,99,66,Average learners
2661,15,37,39,91,60,Average learners
2662,40,40,20,100,66,Average learners
2663,45,35,30,110,73,fast learners
2664,24,18,29,71,47,slow leaners
2665,42,43,48,133,88,fast learners
2666,39,23,48,110,73,fast learners
2667,21,22,44,87,58,Average learners
2668,29,48,20,97,64,Average learners
2669,35,39,15,89,59,Average learners
2670,10,14,13,37,24,slow leaners
2671,44,14,25,83,55,Average learners
2672,20,23,23,66,44,slow leaners
2673,25,14,49,88,58,Average learners
2674,39,26,38,103,68,Average learners
2675,36,48,28,112,74,fast learners
2676,40,43,35,118,78,fast learners
2677,18,45,26,89,59,Average learners
2678,20,26,38,84,56,Average learners
2679,21,30,34,85,56,Average learners
2680,12,18,33,63,42,slow leaners
2681,34,24,33,91,60,Average learners
2682,11,13,34,58,38,slow leaners
2683,33,46,40,119,79,fast learners
2684,20,32,30,82,54,Average learners
2685,34,27,16,77,51,Average learners
2686,14,33,19,66,44,slow leaners
2687,34,12,15,61,40,slow leaners
2688,31,43,18,92,61,Average learners
2689,46,29,24,99,66,Average learners
2690,22,44,41,107,71,fast learners
2691,41,31,14,86,57,Average learners
2692,15,10,26,51,34,slow leaners
2693,14,48,41,103,68,Average learners
2694,47,14,35,96,64,Average learners
2695,37,44,15,96,64,Average learners
2696,38,28,27,93,62,Average learners
2697,16,31,22,69,46,slow leaners
2698,32,48,45,125,83,fast learners
2699,24,37,25,86,57,Average learners
2700,17,21,34,72,48,slow leaners
2701,46,13,14,73,48,slow leaners
2702,49,29,17,95,63,Average learners
2703,38,49,24,111,74,fast learners
2704,20,27,39,86,57,Average learners
2705,39,37,14,90,60,Average learners
2706,19,17,43,79,52,Average learners
2707,17,27,14,58,38,slow leaners
2708,10,38,22,70,46,slow leaners
2709,19,35,39,93,62,Average learners
2710,29,37,38,104,69,Average learners
2711,39,10,46,95,63,Average learners
2712,21,39,22,82,54,Average learners
2713,49,26,40,115,76,fast learners
2714,34,22,35,91,60,Average learners
2715,34,49,41,124,82,fast learners
2716,23,49,39,111,74,fast learners
2717,49,34,30,113,75,fast learners
2718,49,13,28,90,60,Average learners
2719,39,34,10,83,55,Average learners
2720,17,17,30,64,42,slow leaners
2721,27,25,26,78,52,Average learners
2722,14,37,47,98,65,Average learners
2723,19,13,23,55,36,slow leaners
2724,28,32,14,74,49,slow leaners
2725,30,18,48,96,64,Average learners
2726,42,10,22,74,49,slow leaners
2727,47,38,13,98,65,Average learners
2728,20,22,42,84,56,Average learners
2729,27,21,22,70,46,slow leaners
2730,22,16,15,53,35,slow leaners
2731,37,20,11,68,45,slow leaners
2732,29,24,42,95,63,Average learners
2733,24,35,25,84,56,Average learners
2734,15,25,15,55,36,slow leaners
2735,34,19,30,83,55,Average learners
2736,16,21,20,57,38,slow leaners
2737,25,10,42,77,51,Average learners
2738,18,28,31,77,51,Average learners
2739,47,36,44,127,84,fast learners
2740,24,20,38,82,54,Average learners
2741,27,17,42,86,57,Average learners
2742,38,19,13,70,46,slow leaners
2743,32,38,39,109,72,fast learners
2744,20,13,20,53,35,slow leaners
2745,47,47,29,123,82,fast learners
2746,27,17,44,88,58,Average learners
2747,34,25,27,86,57,Average learners
2748,37,17,12,66,44,slow leaners
2749,31,36,12,79,52,Average learners
2750,33,42,18,93,62,Average learners
2751,29,45,18,92,61,Average learners
2752,38,14,41,93,62,Average learners
2753,17,48,32,97,64,Average learners
2754,49,44,15,108,72,fast learners
2755,10,40,10,60,40,slow leaners
2756,13,40,25,78,52,Average learners
2757,19,33,37,89,59,Average learners
2758,10,42,25,77,51,Average learners
2759,20,26,36,82,54,Average learners
2760,42,11,44,97,64,Average learners
2761,45,42,47,134,89,fast learners
2762,17,49,10,76,50,Average learners
2763,42,46,41,129,86,fast learners
2764,42,20,29,91,60,Average learners
2765,49,38,41,128,85,fast learners
2766,29,25,20,74,49,slow leaners
2767,11,46,14,71,47,slow leaners
2768,37,27,31,95,63,Average learners
2769,49,43,21,113,75,fast learners
2770,33,20,33,86,57,Average learners
2771,46,39,28,113,75,fast learners
2772,17,33,49,99,66,Average learners
2773,39,16,16,71,47,slow leaners
2774,21,27,18,66,44,slow leaners
2775,36,40,37,113,75,fast learners
2776,43,32,46,121,80,fast learners
2777,34,28,21,83,55,Average learners
2778,19,39,13,71,47,slow leaners
2779,47,47,19,113,75,fast learners
2780,48,33,35,116,77,fast learners
2781,27,38,22,87,58,Average learners
2782,30,36,29,95,63,Average learners
2783,10,25,38,73,48,slow leaners
2784,31,40,43,114,76,fast learners
2785,48,38,31,117,78,fast learners
2786,49,26,38,113,75,fast learners
2787,20,32,12,64,42,slow leaners
2788,44,24,16,84,56,Average learners
2789,43,30,41,114,76,fast learners
2790,11,37,41,89,59,Average learners
2791,49,31,12,92,61,Average learners
2792,24,33,48,105,70,fast learners
2793,12,32,35,79,52,Average learners
2794,20,39,26,85,56,Average learners
2795,41,12,15,68,45,slow leaners
2796,49,26,33,108,72,fast learners
2797,20,34,49,103,68,Average learners
2798,26,41,44,111,74,fast learners
2799,21,40,12,73,48,slow leaners
2800,12,41,36,89,59,Average learners
2801,21,21,42,84,56,Average learners
2802,48,22,46,116,77,fast learners
2803,20,37,21,78,52,Average learners
2804,28,32,43,103,68,Average learners
2805,21,28,28,77,51,Average learners
2806,19,22,47,88,58,Average learners
2807,49,21,31,101,67,Average learners
2808,49,46,26,121,80,fast learners
2809,41,18,42,101,67,Average learners
2810,28,19,22,69,46,slow leaners
2811,13,35,16,64,42,slow leaners
2812,29,44,30,103,68,Average learners
2813,15,38,22,75,50,Average learners
2814,41,16,12,69,46,slow leaners
2815,37,45,10,92,61,Average learners
2816,37,45,24,106,70,fast learners
2817,43,14,39,96,64,Average learners
2818,42,10,20,72,48,slow leaners
2819,47,45,42,134,89,fast learners
2820,22,22,30,74,49,slow leaners
2821,20,24,15,59,39,slow leaners
2822,49,25,15,89,59,Average learners
2823,24,48,42,114,76,fast learners
2824,12,39,25,76,50,Average learners
2825,31,47,47,125,83,fast learners
2826,22,29,17,68,45,slow leaners
2827,18,39,36,93,62,Average learners
2828,42,42,44,128,85,fast learners
2829,25,34,47,106,70,fast learners
2830,33,18,39,90,60,Average learners
2831,20,40,11,71,47,slow leaners
2832,16,44,39,99,66,Average learners
2833,10,24,46,80,53,Average learners
2834,31,21,14,66,44,slow leaners
2835,45,13,16,74,49,slow leaners
2836,32,27,20,79,52,Average learners
2837,16,18,21,55,36,slow leaners
2838,43,20,42,105,70,fast learners
2839,12,46,43,101,67,Average learners
2840,39,48,47,134,89,fast learners
2841,43,26,35,104,69,Average learners
2842,21,22,37,80,53,Average learners
2843,13,44,31,88,58,Average learners
2844,40,30,48,118,78,fast learners
2845,35,40,42,117,78,fast learners
2846,10,32,43,85,56,Average learners
2847,46,17,16,79,52,Average learners
2848,14,18,18,50,33,slow leaners
2849,46,49,36,131,87,fast learners
2850,32,27,35,94,62,Average learners
2851,42,34,32,108,72,fast learners
2852,16,40,46,102,68,Average learners
2853,42,36,37,115,76,fast learners
2854,12,19,43,74,49,slow leaners
2855,41,23,24,88,58,Average learners
2856,30,13,42,85,56,Average learners
2857,16,42,18,76,50,Average learners
2858,27,39,20,86,57,Average learners
2859,24,34,39,97,64,Average learners
2860,38,46,22,106,70,fast learners
2861,42,36,39,117,78,fast learners
2862,18,49,32,99,66,Average learners
2863,16,49,28,93,62,Average learners
2864,35,11,23,69,46,slow leaners
2865,40,26,38,104,69,Average learners
2866,37,46,14,97,64,Average learners
2867,30,32,31,93,62,Average learners
2868,35,24,34,93,62,Average learners
2869,33,13,45,91,60,Average learners
2870,13,39,12,64,42,slow leaners
2871,23,25,35,83,55,Average learners
2872,45,25,30,100,66,Average learners
2873,16,41,25,82,54,Average learners
2874,25,29,42,96,64,Average learners
2875,37,39,49,125,83,fast learners
2876,16,23,49,88,58,Average learners
2877,28,15,43,86,57,Average learners
2878,44,35,10,89,59,Average learners
2879,26,25,49,100,66,Average learners
2880,43,18,36,97,64,Average learners
2881,27,44,26,97,64,Average learners
2882,37,31,36,104,69,Average learners
2883,13,40,24,77,51,Average learners
2884,10,11,34,55,36,slow leaners
2885,21,19,30,70,46,slow leaners
2886,48,25,25,98,65,Average learners
2887,38,42,20,100,66,Average learners
2888,29,44,35,108,72,fast learners
2889,23,36,25,84,56,Average learners
2890,45,17,28,90,60,Average learners
2891,47,30,24,101,67,Average learners
2892,38,32,42,112,74,fast learners
2893,40,11,41,92,61,Average learners
2894,17,48,26,91,60,Average learners
2895,42,32,16,90,60,Average learners
2896,35,20,46,101,67,Average learners
2897,28,48,49,125,83,fast learners
2898,42,23,42,107,71,fast learners
2899,38,26,14,78,52,Average learners
2900,21,19,13,53,35,slow leaners
2901,12,33,15,60,40,slow leaners
2902,28,26,39,93,62,Average learners
2903,40,44,44,128,85,fast learners
2904,34,31,22,87,58,Average learners
2905,28,43,26,97,64,Average learners
2906,45,17,42,104,69,Average learners
2907,25,13,34,72,48,slow leaners
2908,47,39,48,134,89,fast learners
2909,33,10,38,81,54,Average learners
2910,19,26,20,65,43,slow leaners
2911,45,15,24,84,56,Average learners
2912,16,42,17,75,50,Average learners
2913,34,10,13,57,38,slow leaners
2914,43,25,40,108,72,fast learners
2915,16,39,26,81,54,Average learners
2916,47,17,24,88,58,Average learners
2917,37,34,43,114,76,fast learners
2918,31,25,34,90,60,Average learners
2919,49,48,44,141,94,fast learners
2920,17,35,40,92,61,Average learners
2921,11,18,28,57,38,slow leaners
2922,29,41,41,111,74,fast learners
2923,34,15,32,81,54,Average learners
2924,40,13,49,102,68,Average learners
2925,26,38,26,90,60,Average learners
2926,41,31,14,86,57,Average learners
2927,45,21,14,80,53,Average learners
2928,24,23,47,94,62,Average learners
2929,11,29,29,69,46,slow leaners
2930,47,28,30,105,70,fast learners
2931,46,40,18,104,69,Average learners
2932,15,29,25,69,46,slow leaners
2933,40,40,49,129,86,fast learners
2934,22,36,18,76,50,Average learners
2935,34,35,14,83,55,Average learners
2936,10,27,46,83,55,Average learners
2937,24,12,36,72,48,slow leaners
2938,39,27,30,96,64,Average learners
2939,29,48,30,107,71,fast learners
2940,35,36,22,93,62,Average learners
2941,26,40,41,107,71,fast learners
2942,21,38,12,71,47,slow leaners
2943,28,42,23,93,62,Average learners
2944,31,26,49,106,70,fast learners
2945,46,14,18,78,52,Average learners
2946,21,40,48,109,72,fast learners
2947,12,17,38,67,44,slow leaners
2948,47,38,13,98,65,Average learners
2949,42,31,28,101,67,Average learners
2950,17,18,30,65,43,slow leaners
2951,20,17,16,53,35,slow leaners
2952,24,45,13,82,54,Average learners
2953,47,15,17,79,52,Average learners
2954,45,12,13,70,46,slow leaners
2955,36,23,20,79,52,Average learners
2956,31,43,15,89,59,Average learners
2957,29,45,46,120,80,fast learners
2958,18,38,25,81,54,Average learners
2959,45,29,34,108,72,fast learners
2960,14,24,18,56,37,slow leaners
2961,32,14,30,76,50,Average learners
2962,24,14,43,81,54,Average learners
2963,39,37,11,87,58,Average learners
2964,43,15,25,83,55,Average learners
2965,10,42,45,97,64,Average learners
2966,47,37,39,123,82,fast learners
2967,46,28,22,96,64,Average learners
2968,48,19,34,101,67,Average learners
2969,23,46,31,100,66,Average learners
2970,10,28,11,49,32,slow leaners
2971,30,48,47,125,83,fast learners
2972,39,45,22,106,70,fast learners
2973,41,21,16,78,52,Average learners
2974,36,25,23,84,56,Average learners
2975,48,40,16,104,69,Average learners
2976,45,18,23,86,57,Average learners
2977,26,43,21,90,60,Average learners
2978,25,29,49,103,68,Average learners
2979,37,12,30,79,52,Average learners
2980,28,31,44,103,68,Average learners
2981,48,43,34,125,83,fast learners
2982,34,48,18,100,66,Average learners
2983,10,24,37,71,47,slow leaners
2984,31,35,20,86,57,Average learners
2985,45,23,49,117,78,fast learners
2986,43,44,36,123,82,fast learners
2987,33,49,27,109,72,fast learners
2988,27,40,43,110,73,fast learners
2989,26,29,33,88,58,Average learners
2990,22,33,22,77,51,Average learners
2991,21,15,27,63,42,slow leaners
2992,33,35,23,91,60,Average learners
2993,26,15,17,58,38,slow leaners
2994,48,18,13,79,52,Average learners
2995,47,16,35,98,65,Average learners
2996,45,40,31,116,77,fast learners
2997,49,26,10,85,56,Average learners
2998,43,22,20,85,56,Average learners
2999,21,28,22,71,47,slow leaners
3000,35,26,17,78,52,Average learners
3001,25,39,23,87,58,Average learners
3002,13,47,22,82,54,Average learners
3003,40,32,10,82,54,Average learners
3004,47,42,11,100,66,Average learners
3005,27,42,16,85,56,Average learners
3006,28,47,29,104,69,Average learners
3007,48,47,28,123,82,fast learners
3008,40,42,24,106,70,fast learners
3009,42,49,49,140,93,fast learners
3010,45,27,13,85,56,Average learners
3011,17,35,30,82,54,Average learners
3012,11,28,20,59,39,slow leaners
3013,34,29,47,110,73,fast learners
3014,40,24,44,108,72,fast learners
3015,45,22,45,112,74,fast learners
3016,31,42,14,87,58,Average learners
3017,26,21,12,59,39,slow leaners
3018,36,31,19,86,57,Average learners
3019,14,11,43,68,45,slow leaners
3020,25,20,24,69,46,slow leaners
3021,10,40,10,60,40,slow leaners
3022,48,37,41,126,84,fast learners
3023,48,44,49,141,94,fast learners
3024,28,11,40,79,52,Average learners
3025,49,40,17,106,70,fast learners
3026,16,10,48,74,49,slow leaners
3027,11,35,22,68,45,slow leaners
3028,34,10,30,74,49,slow leaners
3029,44,19,25,88,58,Average learners
3030,30,24,20,74,49,slow leaners
3031,44,38,28,110,73,fast learners
3032,35,14,31,80,53,Average learners
3033,28,14,26,68,45,slow leaners
3034,19,12,11,42,28,slow leaners
3035,33,14,36,83,55,Average learners
3036,23,43,20,86,57,Average learners
3037,45,25,38,108,72,fast learners
3038,19,38,16,73,48,slow leaners
3039,31,49,44,124,82,fast learners
3040,22,39,42,103,68,Average learners
3041,29,49,12,90,60,Average learners
3042,20,12,16,48,32,slow leaners
3043,38,22,19,79,52,Average learners
3044,10,42,20,72,48,slow leaners
3045,33,25,15,73,48,slow leaners
3046,34,30,20,84,56,Average learners
3047,14,28,15,57,38,slow leaners
3048,24,16,14,54,36,slow leaners
3049,34,17,17,68,45,slow leaners
3050,24,24,25,73,48,slow leaners
3051,39,14,19,72,48,slow leaners
3052,21,25,10,56,37,slow leaners
3053,44,29,14,87,58,Average learners
3054,36,30,42,108,72,fast learners
3055,39,18,36,93,62,Average learners
3056,37,10,45,92,61,Average learners
3057,18,23,17,58,38,slow leaners
3058,41,38,49,128,85,fast learners
3059,28,13,49,90,60,Average learners
3060,35,45,40,120,80,fast learners
3061,22,19,42,83,55,Average learners
3062,17,29,49,95,63,Average learners
3063,16,33,16,65,43,slow leaners
3064,41,13,27,81,54,Average learners
3065,26,10,36,72,48,slow leaners
3066,49,34,12,95,63,Average learners
3067,18,14,22,54,36,slow leaners
3068,43,23,13,79,52,Average learners
3069,24,14,34,72,48,slow leaners
3070,12,40,32,84,56,Average learners
3071,38,35,28,101,67,Average learners
3072,32,27,43,102,68,Average learners
3073,29,49,32,110,73,fast learners
3074,12,12,17,41,27,slow leaners
3075,31,10,26,67,44,slow leaners
3076,40,47,30,117,78,fast learners
3077,11,12,20,43,28,slow leaners
3078,30,27,40,97,64,Average learners
3079,29,15,41,85,56,Average learners
3080,14,36,36,86,57,Average learners
3081,49,36,19,104,69,Average learners
3082,37,29,16,82,54,Average learners
3083,45,18,49,112,74,fast learners
3084,44,31,28,103,68,Average learners
3085,11,41,35,87,58,Average learners
3086,15,23,19,57,38,slow leaners
3087,46,36,47,129,86,fast learners
3088,44,40,10,94,62,Average learners
3089,33,13,17,63,42,slow leaners
3090,22,33,33,88,58,Average learners
3091,20,26,20,66,44,slow leaners
3092,38,11,27,76,50,Average learners
3093,14,34,40,88,58,Average learners
3094,12,21,28,61,40,slow leaners
3095,17,47,40,104,69,Average learners
3096,40,21,23,84,56,Average learners
3097,22,23,14,59,39,slow leaners
3098,14,45,44,103,68,Average learners
3099,14,46,37,97,64,Average learners
3100,12,44,45,101,67,Average learners
3101,33,19,49,101,67,Average learners
3102,44,28,26,98,65,Average learners
3103,36,25,25,86,57,Average learners
3104,13,12,22,47,31,slow leaners
3105,15,33,17,65,43,slow leaners
3106,38,18,25,81,54,Average learners
3107,21,36,20,77,51,Average learners
3108,15,46,10,71,47,slow leaners
3109,32,28,37,97,64,Average learners
3110,25,26,30,81,54,Average learners
3111,46,37,32,115,76,fast learners
3112,14,27,12,53,35,slow leaners
3113,25,41,47,113,75,fast learners
3114,45,28,27,100,66,Average learners
3115,18,39,15,72,48,slow leaners
3116,28,24,33,85,56,Average learners
3117,36,36,42,114,76,fast learners
3118,26,23,24,73,48,slow leaners
3119,30,12,35,77,51,Average learners
3120,34,19,41,94,62,Average learners
3121,15,36,14,65,43,slow leaners
3122,13,36,33,82,54,Average learners
3123,16,19,19,54,36,slow leaners
3124,16,38,14,68,45,slow leaners
3125,43,39,31,113,75,fast learners
3126,48,34,16,98,65,Average learners
3127,42,21,20,83,55,Average learners
3128,22,39,31,92,61,Average learners
3129,40,39,45,124,82,fast learners
3130,10,15,33,58,38,slow leaners
3131,37,26,29,92,61,Average learners
3132,35,31,30,96,64,Average learners
3133,19,47,35,101,67,Average learners
3134,45,18,49,112,74,fast learners
3135,26,27,30,83,55,Average learners
3136,13,11,19,43,28,slow leaners
3137,17,46,20,83,55,Average learners
3138,21,12,19,52,34,slow leaners
3139,35,24,15,74,49,slow leaners
3140,24,41,13,78,52,Average learners
3141,43,46,10,99,66,Average learners
3142,16,42,38,96,64,Average learners
3143,17,42,23,82,54,Average learners
3144,44,33,48,125,83,fast learners
3145,26,29,34,89,59,Average learners
3146,34,46,38,118,78,fast learners
3147,30,13,30,73,48,slow leaners
3148,27,44,45,116,77,fast learners
3149,16,11,27,54,36,slow leaners
3150,22,39,11,72,48,slow leaners
3151,16,19,40,75,50,Average learners
3152,13,36,39,88,58,Average learners
3153,21,28,32,81,54,Average learners
3154,42,43,29,114,76,fast learners
3155,30,43,23,96,64,Average learners
3156,25,28,26,79,52,Average learners
3157,34,33,39,106,70,fast learners
3158,18,14,38,70,46,slow leaners
3159,24,45,21,90,60,Average learners
3160,36,27,34,97,64,Average learners
3161,26,33,31,90,60,Average learners
3162,49,11,18,78,52,Average learners
3163,26,40,39,105,70,fast learners
3164,16,30,39,85,56,Average learners
3165,27,22,34,83,55,Average learners
3166,25,21,45,91,60,Average learners
3167,37,33,37,107,71,fast learners
3168,46,46,48,140,93,fast learners
3169,18,37,15,70,46,slow leaners
3170,22,24,18,64,42,slow leaners
3171,24,27,30,81,54,Average learners
3172,15,20,21,56,37,slow leaners
3173,17,39,16,72,48,slow leaners
3174,36,33,18,87,58,Average learners
3175,36,21,34,91,60,Average learners
3176,39,42,20,101,67,Average learners
3177,19,12,43,74,49,slow leaners
3178,17,10,37,64,42,slow leaners
3179,31,47,31,109,72,fast learners
3180,32,49,35,116,77,fast learners
3181,12,10,10,32,21,slow leaners
3182,31,16,15,62,41,slow leaners
3183,40,12,46,98,65,Average learners
3184,46,23,28,97,64,Average learners
3185,36,19,46,101,67,Average learners
3186,18,25,18,61,40,slow leaners
3187,46,23,49,118,78,fast learners
3188,38,49,10,97,64,Average learners
3189,36,20,40,96,64,Average learners
3190,25,37,16,78,52,Average learners
3191,25,37,34,96,64,Average learners
3192,17,34,39,90,60,Average learners
3193,33,25,28,86,57,Average learners
3194,11,35,19,65,43,slow leaners
3195,14,25,39,78,52,Average learners
3196,39,37,37,113,75,fast learners
3197,37,37,40,114,76,fast learners
3198,45,16,31,92,61,Average learners
3199,29,19,14,62,41,slow leaners
3200,24,38,39,101,67,Average learners
3201,40,40,35,115,76,fast learners
3202,16,20,42,78,52,Average learners
3203,43,31,25,99,66,Average learners
3204,21,43,43,107,71,fast learners
3205,37,32,43,112,74,fast learners
3206,20,17,23,60,40,slow leaners
3207,49,45,23,117,78,fast learners
3208,36,32,23,91,60,Average learners
3209,41,42,47,130,86,fast learners
3210,41,10,42,93,62,Average learners
3211,38,10,28,76,50,Average learners
3212,13,24,37,74,49,slow leaners
3213,13,41,37,91,60,Average learners
3214,39,33,43,115,76,fast learners
3215,28,28,44,100,66,Average learners
3216,28,48,14,90,60,Average learners
3217,22,21,34,77,51,Average learners
3218,46,46,15,107,71,fast learners
3219,23,22,42,87,58,Average learners
3220,45,27,49,121,80,fast learners
3221,11,29,36,76,50,Average learners
3222,22,33,22,77,51,Average learners
3223,21,15,16,52,34,slow leaners
3224,33,39,32,104,69,Average learners
3225,27,30,13,70,46,slow leaners
3226,25,38,45,108,72,fast learners
3227,41,19,30,90,60,Average learners
3228,33,41,17,91,60,Average learners
3229,36,20,47,103,68,Average learners
3230,44,43,17,104,69,Average learners
3231,22,42,43,107,71,fast learners
3232,29,36,48,113,75,fast learners
3233,37,43,34,114,76,fast learners
3234,14,14,36,64,42,slow leaners
3235,33,17,26,76,50,Average learners
3236,26,28,20,74,49,slow leaners
3237,47,17,20,84,56,Average learners
3238,25,41,35,101,67,Average learners
3239,26,24,32,82,54,Average learners
3240,48,10,20,78,52,Average learners
3241,22,40,21,83,55,Average learners
3242,42,14,30,86,57,Average learners
3243,26,30,16,72,48,slow leaners
3244,24,24,16,64,42,slow leaners
3245,28,27,19,74,49,slow leaners
3246,26,43,20,89,59,Average learners
3247,27,28,29,84,56,Average learners
3248,30,10,35,75,50,Average learners
3249,42,18,37,97,64,Average learners
3250,34,45,11,90,60,Average learners
3251,43,33,13,89,59,Average learners
3252,35,40,12,87,58,Average learners
3253,27,37,36,100,66,Average learners
3254,38,11,35,84,56,Average learners
3255,22,19,19,60,40,slow leaners
3256,37,18,17,72,48,slow leaners
3257,17,49,41,107,71,fast learners
3258,18,39,18,75,50,Average learners
3259,46,35,39,120,80,fast learners
3260,44,36,21,101,67,Average learners
3261,31,39,32,102,68,Average learners
3262,46,42,45,133,88,fast learners
3263,49,42,26,117,78,fast learners
3264,45,26,46,117,78,fast learners
3265,26,33,21,80,53,Average learners
3266,29,35,45,109,72,fast learners
3267,38,25,13,76,50,Average learners
3268,11,25,48,84,56,Average learners
3269,19,29,44,92,61,Average learners
3270,47,32,32,111,74,fast learners
3271,25,29,32,86,57,Average learners
3272,46,33,31,110,73,fast learners
3273,20,18,16,54,36,slow leaners
3274,24,12,36,72,48,slow leaners
3275,49,24,27,100,66,Average learners
3276,47,21,37,105,70,fast learners
3277,11,37,35,83,55,Average learners
3278,18,39,30,87,58,Average learners
3279,41,10,11,62,41,slow leaners
3280,22,38,23,83,55,Average learners
3281,12,11,22,45,30,slow leaners
3282,18,45,42,105,70,fast learners
3283,13,43,20,76,50,Average learners
3284,48,42,33,123,82,fast learners
3285,24,37,33,94,62,Average learners
3286,43,22,14,79,52,Average learners
3287,23,24,13,60,40,slow leaners
3288,35,16,16,67,44,slow leaners
3289,31,30,17,78,52,Average learners
3290,31,38,29,98,65,Average learners
3291,15,12,36,63,42,slow leaners
3292,23,42,36,101,67,Average learners
3293,12,32,31,75,50,Average learners
3294,44,45,46,135,90,fast learners
3295,33,37,44,114,76,fast learners
3296,37,41,19,97,64,Average learners
3297,23,34,30,87,58,Average learners
3298,42,13,40,95,63,Average learners
3299,27,40,26,93,62,Average learners
3300,46,43,19,108,72,fast learners
3301,47,35,17,99,66,Average learners
3302,21,28,47,96,64,Average learners
3303,28,20,35,83,55,Average learners
3304,42,12,23,77,51,Average learners
3305,20,19,17,56,37,slow leaners
3306,45,39,34,118,78,fast learners
3307,32,14,48,94,62,Average learners
3308,16,17,31,64,42,slow leaners
3309,45,48,25,118,78,fast learners
3310,27,21,33,81,54,Average learners
3311,22,27,43,92,61,Average learners
3312,33,41,23,97,64,Average learners
3313,35,33,25,93,62,Average learners
3314,48,11,44,103,68,Average learners
3315,34,11,43,88,58,Average learners
3316,48,43,37,128,85,fast learners
3317,13,10,27,50,33,slow leaners
3318,19,21,13,53,35,slow leaners
3319,10,46,23,79,52,Average learners
3320,34,24,18,76,50,Average learners
3321,31,39,13,83,55,Average learners
3322,26,42,19,87,58,Average learners
3323,28,21,32,81,54,Average learners
3324,42,42,39,123,82,fast learners
3325,25,20,15,60,40,slow leaners
3326,22,19,26,67,44,slow leaners
3327,47,40,12,99,66,Average learners
3328,23,21,32,76,50,Average learners
3329,31,41,23,95,63,Average learners
3330,33,39,29,101,67,Average learners
3331,25,10,31,66,44,slow leaners
3332,47,17,25,89,59,Average learners
3333,19,34,19,72,48,slow leaners
3334,49,24,25,98,65,Average learners
3335,11,17,48,76,50,Average learners
3336,11,44,15,70,46,slow leaners
3337,26,41,38,105,70,fast learners
3338,30,35,37,102,68,Average learners
3339,13,26,29,68,45,slow leaners
3340,47,20,18,85,56,Average learners
3341,13,31,42,86,57,Average learners
3342,26,48,32,106,70,fast learners
3343,46,25,49,120,80,fast learners
3344,16,34,18,68,45,slow leaners
3345,47,40,26,113,75,fast learners
3346,30,29,38,97,64,Average learners
3347,20,19,49,88,58,Average learners
3348,13,32,48,93,62,Average learners
3349,21,34,21,76,50,Average learners
3350,22,48,31,101,67,Average learners
3351,15,36,13,64,42,slow leaners
3352,45,10,25,80,53,Average learners
3353,31,14,13,58,38,slow leaners
3354,20,44,40,104,69,Average learners
3355,15,11,31,57,38,slow leaners
3356,29,26,16,71,47,slow leaners
3357,32,15,22,69,46,slow leaners
3358,25,47,11,83,55,Average learners
3359,25,38,31,94,62,Average learners
3360,38,45,37,120,80,fast learners
3361,39,39,29,107,71,fast learners
3362,33,23,39,95,63,Average learners
3363,36,40,36,112,74,fast learners
3364,20,47,32,99,66,Average learners
3365,36,17,19,72,48,slow leaners
3366,37,30,27,94,62,Average learners
3367,12,12,10,34,22,slow leaners
3368,30,34,41,105,70,fast learners
3369,20,19,15,54,36,slow leaners
3370,22,30,15,67,44,slow leaners
3371,30,25,41,96,64,Average learners
3372,36,22,40,98,65,Average learners
3373,11,49,17,77,51,Average learners
3374,45,34,37,116,77,fast learners
3375,26,28,37,91,60,Average learners
3376,21,45,43,109,72,fast learners
3377,23,37,10,70,46,slow leaners
3378,33,39,40,112,74,fast learners
3379,49,37,20,106,70,fast learners
3380,31,15,23,69,46,slow leaners
3381,17,22,34,73,48,slow leaners
3382,32,24,28,84,56,Average learners
3383,15,44,39,98,65,Average learners
3384,45,21,28,94,62,Average learners
3385,25,45,33,103,68,Average learners
3386,25,34,46,105,70,fast learners
3387,22,34,22,78,52,Average learners
3388,39,15,11,65,43,slow leaners
3389,11,49,11,71,47,slow leaners
3390,37,48,31,116,77,fast learners
3391,14,40,13,67,44,slow leaners
3392,17,22,43,82,54,Average learners
3393,29,22,28,79,52,Average learners
3394,11,24,23,58,38,slow leaners
3395,48,17,13,78,52,Average learners
3396,12,24,40,76,50,Average learners
3397,48,32,49,129,86,fast learners
3398,11,23,11,45,30,slow leaners
3399,24,15,39,78,52,Average learners
3400,44,21,44,109,72,fast learners
3401,47,25,38,110,73,fast learners
3402,30,33,17,80,53,Average learners
3403,18,19,41,78,52,Average learners
3404,31,46,19,96,64,Average learners
3405,22,37,32,91,60,Average learners
3406,30,23,44,97,64,Average learners
3407,36,38,48,122,81,fast learners
3408,48,17,15,80,53,Average learners
3409,30,29,15,74,49,slow leaners
3410,41,14,17,72,48,slow leaners
3411,15,12,23,50,33,slow leaners
3412,13,44,24,81,54,Average learners
3413,38,26,29,93,62,Average learners
3414,19,35,30,84,56,Average learners
3415,41,33,32,106,70,fast learners
3416,34,38,15,87,58,Average learners
3417,21,10,34,65,43,slow leaners
3418,43,46,47,136,90,fast learners
3419,33,18,32,83,55,Average learners
3420,47,18,28,93,62,Average learners
3421,47,19,17,83,55,Average learners
3422,11,14,13,38,25,slow leaners
3423,10,27,34,71,47,slow leaners
3424,17,47,44,108,72,fast learners
3425,47,29,26,102,68,Average learners
3426,29,39,22,90,60,Average learners
3427,47,10,18,75,50,Average learners
3428,23,37,21,81,54,Average learners
3429,48,13,13,74,49,slow leaners
3430,45,41,18,104,69,Average learners
3431,23,39,38,100,66,Average learners
3432,21,14,27,62,41,slow leaners
3433,31,38,30,99,66,Average learners
3434,35,12,39,86,57,Average learners
3435,25,18,25,68,45,slow leaners
3436,30,17,38,85,56,Average learners
3437,21,10,41,72,48,slow leaners
3438,32,15,38,85,56,Average learners
3439,11,33,44,88,58,Average learners
3440,16,39,48,103,68,Average learners
3441,49,17,24,90,60,Average learners
3442,18,46,40,104,69,Average learners
3443,32,36,34,102,68,Average learners
3444,30,16,14,60,40,slow leaners
3445,15,13,10,38,25,slow leaners
3446,23,12,47,82,54,Average learners
3447,41,33,11,85,56,Average learners
3448,21,10,37,68,45,slow leaners
3449,20,17,24,61,40,slow leaners
3450,49,43,28,120,80,fast learners
3451,28,33,10,71,47,slow leaners
3452,11,28,26,65,43,slow leaners
3453,41,26,32,99,66,Average learners
3454,44,48,48,140,93,fast learners
3455,49,45,32,126,84,fast learners
3456,41,18,37,96,64,Average learners
3457,19,42,24,85,56,Average learners
3458,46,15,45,106,70,fast learners
3459,20,47,33,100,66,Average learners
3460,28,36,26,90,60,Average learners
3461,20,21,32,73,48,slow leaners
3462,28,44,32,104,69,Average learners
3463,37,38,46,121,80,fast learners
3464,27,31,35,93,62,Average learners
3465,14,22,38,74,49,slow leaners
3466,42,34,31,107,71,fast learners
3467,13,37,41,91,60,Average learners
3468,29,37,43,109,72,fast learners
3469,22,49,33,104,69,Average learners
3470,44,18,44,106,70,fast learners
3471,34,16,12,62,41,slow leaners
3472,48,22,31,101,67,Average learners
3473,42,14,24,80,53,Average learners
3474,32,48,10,90,60,Average learners
3475,30,30,34,94,62,Average learners
3476,22,40,44,106,70,fast learners
3477,32,46,11,89,59,Average learners
3478,47,14,12,73,48,slow leaners
3479,26,43,15,84,56,Average learners
3480,10,33,18,61,40,slow leaners
3481,43,49,47,139,92,fast learners
3482,14,30,36,80,53,Average learners
3483,17,29,37,83,55,Average learners
3484,48,19,15,82,54,Average learners
3485,45,18,14,77,51,Average learners
3486,21,17,18,56,37,slow leaners
3487,39,37,11,87,58,Average learners
3488,33,37,27,97,64,Average learners
3489,48,35,18,101,67,Average learners
3490,41,46,45,132,88,fast learners
3491,27,31,29,87,58,Average learners
3492,26,48,16,90,60,Average learners
3493,40,39,21,100,66,Average learners
3494,28,23,10,61,40,slow leaners
3495,17,44,19,80,53,Average learners
3496,31,15,12,58,38,slow leaners
3497,37,37,41,115,76,fast learners
3498,44,20,39,103,68,Average learners
3499,25,48,31,104,69,Average learners
3500,40,16,24,80,53,Average learners
3501,36,43,13,92,61,Average learners
3502,13,11,49,73,48,slow leaners
3503,21,24,15,60,40,slow leaners
3504,31,49,15,95,63,Average learners
3505,17,15,48,80,53,Average learners
3506,25,36,41,102,68,Average learners
3507,28,37,23,88,58,Average learners
3508,12,49,27,88,58,Average learners
3509,27,24,30,81,54,Average learners
3510,27,35,12,74,49,slow leaners
3511,46,14,10,70,46,slow leaners
3512,34,48,23,105,70,fast learners
3513,40,33,18,91,60,Average learners
3514,39,48,35,122,81,fast learners
3515,27,30,13,70,46,slow leaners
3516,18,49,13,80,53,Average learners
3517,21,27,14,62,41,slow leaners
3518,45,35,44,124,82,fast learners
3519,36,21,42,99,66,Average learners
3520,34,43,11,88,58,Average learners
3521,14,40,49,103,68,Average learners
3522,32,31,18,81,54,Average learners
3523,36,20,42,98,65,Average learners
3524,20,28,36,84,56,Average learners
3525,22,49,16,87,58,Average learners
3526,20,19,48,87,58,Average learners
3527,41,30,14,85,56,Average learners
3528,31,14,27,72,48,slow leaners
3529,17,35,30,82,54,Average learners
3530,39,26,46,111,74,fast learners
3531,42,34,30,106,70,fast learners
3532,33,49,40,122,81,fast learners
3533,45,21,12,78,52,Average learners
3534,19,18,31,68,45,slow leaners
3535,12,17,48,77,51,Average learners
3536,47,37,13,97,64,Average learners
3537,45,13,26,84,56,Average learners
3538,21,23,10,54,36,slow leaners
3539,47,13,45,105,70,fast learners
3540,14,21,44,79,52,Average learners
3541,23,35,14,72,48,slow leaners
3542,24,23,30,77,51,Average learners
3543,17,19,28,64,42,slow leaners
3544,20,22,11,53,35,slow leaners
3545,11,47,33,91,60,Average learners
3546,19,21,33,73,48,slow leaners
3547,11,23,47,81,54,Average learners
3548,32,15,34,81,54,Average learners
3549,21,18,26,65,43,slow leaners
3550,19,45,37,101,67,Average learners
3551,42,22,30,94,62,Average learners
3552,26,26,44,96,64,Average learners
3553,49,10,39,98,65,Average learners
3554,21,45,44,110,73,fast learners
3555,34,40,31,105,70,fast learners
3556,47,12,35,94,62,Average learners
3557,40,44,19,103,68,Average learners
3558,43,11,34,88,58,Average learners
3559,40,10,20,70,46,slow leaners
3560,36,18,29,83,55,Average learners
3561,24,22,30,76,50,Average learners
3562,46,47,44,137,91,fast learners
3563,47,41,27,115,76,fast learners
3564,15,29,24,68,45,slow leaners
3565,27,19,30,76,50,Average learners
3566,32,45,35,112,74,fast learners
3567,16,10,16,42,28,slow leaners
3568,29,31,28,88,58,Average learners
3569,22,47,16,85,56,Average learners
3570,19,36,12,67,44,slow leaners
3571,20,16,35,71,47,slow leaners
3572,16,29,32,77,51,Average learners
3573,19,18,12,49,32,slow leaners
3574,36,12,24,72,48,slow leaners
3575,33,48,29,110,73,fast learners
3576,10,35,25,70,46,slow leaners
3577,19,45,45,109,72,fast learners
3578,15,12,38,65,43,slow leaners
3579,33,36,33,102,68,Average learners
3580,25,10,29,64,42,slow leaners
3581,15,13,36,64,42,slow leaners
3582,38,17,13,68,45,slow leaners
3583,40,23,24,87,58,Average learners
3584,26,11,22,59,39,slow leaners
3585,39,43,16,98,65,Average learners
3586,18,15,32,65,43,slow leaners
3587,23,42,11,76,50,Average learners
3588,35,26,44,105,70,fast learners
3589,27,28,28,83,55,Average learners
3590,11,21,19,51,34,slow leaners
3591,33,29,43,105,70,fast learners
3592,25,17,37,79,52,Average learners
3593,26,38,39,103,68,Average learners
3594,39,46,31,116,77,fast learners
3595,21,44,42,107,71,fast learners
3596,34,17,29,80,53,Average learners
3597,32,44,36,112,74,fast learners
3598,15,14,31,60,40,slow leaners
3599,43,45,48,136,90,fast learners
3600,32,27,29,88,58,Average learners
3601,34,18,13,65,43,slow leaners
3602,26,39,24,89,59,Average learners
3603,28,32,32,92,61,Average learners
3604,22,46,47,115,76,fast learners
3605,37,21,31,89,59,Average learners
3606,19,34,17,70,46,slow leaners
3607,37,31,29,97,64,Average learners
3608,45,26,43,114,76,fast learners
3609,20,43,20,83,55,Average learners
3610,29,45,14,88,58,Average learners
3611,33,15,21,69,46,slow leaners
3612,20,16,46,82,54,Average learners
3613,21,19,47,87,58,Average learners
3614,28,24,40,92,61,Average learners
3615,45,40,43,128,85,fast learners
3616,30,32,34,96,64,Average learners
3617,26,34,44,104,69,Average learners
3618,49,46,23,118,78,fast learners
3619,19,26,13,58,38,slow leaners
3620,13,42,33,88,58,Average learners
3621,40,32,27,99,66,Average learners
3622,19,32,22,73,48,slow leaners
3623,48,21,12,81,54,Average learners
3624,27,37,33,97,64,Average learners
3625,46,45,47,138,92,fast learners
3626,16,34,41,91,60,Average learners
3627,45,44,13,102,68,Average learners
3628,16,35,35,86,57,Average learners
3629,44,14,14,72,48,slow leaners
3630,20,35,46,101,67,Average learners
3631,23,47,47,117,78,fast learners
3632,23,32,41,96,64,Average learners
3633,28,38,49,115,76,fast learners
3634,45,22,44,111,74,fast learners
3635,38,28,42,108,72,fast learners
3636,12,31,35,78,52,Average learners
3637,22,13,29,64,42,slow leaners
3638,16,41,44,101,67,Average learners
3639,15,49,45,109,72,fast learners
3640,41,20,43,104,69,Average learners
3641,43,17,27,87,58,Average learners
3642,21,41,35,97,64,Average learners
3643,14,11,17,42,28,slow leaners
3644,22,23,39,84,56,Average learners
3645,42,25,14,81,54,Average learners
3646,43,14,38,95,63,Average learners
3647,17,27,28,72,48,slow leaners
3648,25,12,24,61,40,slow leaners
3649,47,11,30,88,58,Average learners
3650,11,33,26,70,46,slow leaners
3651,10,39,27,76,50,Average learners
3652,10,39,24,73,48,slow leaners
3653,30,44,29,103,68,Average learners
3654,37,27,20,84,56,Average learners
3655,13,30,31,74,49,slow leaners
3656,25,46,45,116,77,fast learners
3657,18,49,33,100,66,Average learners
3658,18,19,28,65,43,slow leaners
3659,45,23,12,80,53,Average learners
3660,27,34,26,87,58,Average learners
3661,30,34,45,109,72,fast learners
3662,49,48,35,132,88,fast learners
3663,14,24,41,79,52,Average learners
3664,39,43,20,102,68,Average learners
3665,48,35,30,113,75,fast learners
3666,19,35,42,96,64,Average learners
3667,41,31,25,97,64,Average learners
3668,28,43,16,87,58,Average learners
3669,26,18,22,66,44,slow leaners
3670,27,40,31,98,65,Average learners
3671,28,16,37,81,54,Average learners
3672,43,45,34,122,81,fast learners
3673,46,42,29,117,78,fast learners
3674,17,25,39,81,54,Average learners
3675,42,20,45,107,71,fast learners
3676,39,20,32,91,60,Average learners
3677,14,45,34,93,62,Average learners
3678,33,22,29,84,56,Average learners
3679,27,21,15,63,42,slow leaners
3680,42,45,23,110,73,fast learners
3681,12,16,27,55,36,slow leaners
3682,41,32,15,88,58,Average learners
3683,10,44,26,80,53,Average learners
3684,40,18,33,91,60,Average learners
3685,40,40,12,92,61,Average learners
3686,35,12,46,93,62,Average learners
3687,28,17,43,88,58,Average learners
3688,36,48,40,124,82,fast learners
3689,21,16,13,50,33,slow leaners
3690,27,20,22,69,46,slow leaners
3691,15,31,28,74,49,slow leaners
3692,49,24,19,92,61,Average learners
3693,22,37,17,76,50,Average learners
3694,47,24,33,104,69,Average learners
3695,31,11,36,78,52,Average learners
3696,19,22,22,63,42,slow leaners
3697,39,39,36,114,76,fast learners
3698,38,30,38,106,70,fast learners
3699,22,21,25,68,45,slow leaners
3700,27,13,44,84,56,Average learners
3701,40,30,18,88,58,Average learners
3702,30,14,18,62,41,slow leaners
3703,37,47,31,115,76,fast learners
3704,13,48,46,107,71,fast learners
3705,40,19,39,98,65,Average learners
3706,32,42,13,87,58,Average learners
3707,47,36,27,110,73,fast learners
3708,25,40,22,87,58,Average learners
3709,36,24,20,80,53,Average learners
3710,19,34,31,84,56,Average learners
3711,29,26,29,84,56,Average learners
3712,47,34,34,115,76,fast learners
3713,27,48,35,110,73,fast learners
3714,17,47,31,95,63,Average learners
3715,21,29,29,79,52,Average learners
3716,11,26,36,73,48,slow leaners
3717,12,17,17,46,30,slow leaners
3718,44,15,43,102,68,Average learners
3719,15,24,24,63,42,slow leaners
3720,13,49,45,107,71,fast learners
3721,40,10,25,75,50,Average learners
3722,15,36,33,84,56,Average learners
3723,40,19,10,69,46,slow leaners
3724,31,13,12,56,37,slow leaners
3725,32,36,12,80,53,Average learners
3726,30,25,13,68,45,slow leaners
3727,28,37,25,90,60,Average learners
3728,28,48,41,117,78,fast learners
3729,15,33,19,67,44,slow leaners
3730,19,30,36,85,56,Average learners
3731,18,46,14,78,52,Average learners
3732,12,41,16,69,46,slow leaners
3733,25,38,19,82,54,Average learners
3734,43,44,47,134,89,fast learners
3735,29,41,21,91,60,Average learners
3736,14,34,10,58,38,slow leaners
3737,18,38,33,89,59,Average learners
3738,10,17,14,41,27,slow leaners
3739,46,41,35,122,81,fast learners
3740,31,46,49,126,84,fast learners
3741,41,48,36,125,83,fast learners
3742,21,21,38,80,53,Average learners
3743,34,30,17,81,54,Average learners
3744,46,31,20,97,64,Average learners
3745,10,47,45,102,68,Average learners
3746,32,45,31,108,72,fast learners
3747,13,32,16,61,40,slow leaners
3748,27,48,12,87,58,Average learners
3749,48,44,47,139,92,fast learners
3750,48,35,15,98,65,Average learners
3751,37,10,22,69,46,slow leaners
3752,35,39,22,96,64,Average learners
3753,21,42,48,111,74,fast learners
3754,43,28,25,96,64,Average learners
3755,14,22,34,70,46,slow leaners
3756,39,17,25,81,54,Average learners
3757,25,34,28,87,58,Average learners
3758,47,22,37,106,70,fast learners
3759,21,18,28,67,44,slow leaners
3760,39,22,15,76,50,Average learners
3761,22,48,45,115,76,fast learners
3762,17,43,25,85,56,Average learners
3763,28,15,17,60,40,slow leaners
3764,30,34,36,100,66,Average learners
3765,16,47,39,102,68,Average learners
3766,49,16,34,99,66,Average learners
3767,46,35,37,118,78,fast learners
3768,32,24,15,71,47,slow leaners
3769,31,15,40,86,57,Average learners
3770,11,29,15,55,36,slow leaners
3771,16,30,34,80,53,Average learners
3772,18,24,25,67,44,slow leaners
3773,41,23,36,100,66,Average learners
3774,11,11,32,54,36,slow leaners
3775,26,16,19,61,40,slow leaners
3776,48,28,36,112,74,fast learners
3777,43,25,17,85,56,Average learners
3778,39,24,24,87,58,Average learners
3779,21,34,38,93,62,Average learners
3780,48,33,14,95,63,Average learners
3781,45,18,46,109,72,fast learners
3782,27,13,49,89,59,Average learners
3783,15,34,48,97,64,Average learners
3784,45,21,41,107,71,fast learners
3785,43,25,42,110,73,fast learners
3786,32,36,16,84,56,Average learners
3787,15,45,32,92,61,Average learners
3788,45,10,38,93,62,Average learners
3789,42,42,20,104,69,Average learners
3790,30,10,46,86,57,Average learners
3791,49,28,44,121,80,fast learners
3792,42,46,21,109,72,fast learners
3793,31,27,30,88,58,Average learners
3794,34,25,34,93,62,Average learners
3795,30,36,44,110,73,fast learners
3796,21,44,37,102,68,Average learners
3797,18,29,28,75,50,Average learners
3798,18,26,23,67,44,slow leaners
3799,27,26,45,98,65,Average learners
3800,12,32,22,66,44,slow leaners
3801,30,13,47,90,60,Average learners
3802,10,29,22,61,40,slow leaners
3803,30,21,37,88,58,Average learners
3804,20,24,35,79,52,Average learners
3805,27,43,48,118,78,fast learners
3806,17,42,29,88,58,Average learners
3807,22,46,33,101,67,Average learners
3808,35,28,36,99,66,Average learners
3809,33,47,13,93,62,Average learners
3810,33,18,32,83,55,Average learners
3811,12,48,24,84,56,Average learners
3812,11,28,31,70,46,slow leaners
3813,20,33,16,69,46,slow leaners
3814,24,27,32,83,55,Average learners
3815,12,11,37,60,40,slow leaners
3816,28,45,48,121,80,fast learners
3817,13,12,20,45,30,slow leaners
3818,11,24,10,45,30,slow leaners
3819,45,14,33,92,61,Average learners
3820,19,19,35,73,48,slow leaners
3821,34,21,25,80,53,Average learners
3822,22,37,43,102,68,Average learners
3823,42,22,42,106,70,fast learners
3824,31,34,44,109,72,fast learners
3825,14,44,45,103,68,Average learners
3826,45,33,21,99,66,Average learners
3827,27,44,20,91,60,Average learners
3828,16,47,45,108,72,fast learners
3829,16,28,23,67,44,slow leaners
3830,26,35,18,79,52,Average learners
3831,26,16,33,75,50,Average learners
3832,48,41,42,131,87,fast learners
3833,12,32,17,61,40,slow leaners
3834,29,40,34,103,68,Average learners
3835,45,39,37,121,80,fast learners
3836,49,36,28,113,75,fast learners
3837,21,20,30,71,47,slow leaners
3838,14,40,12,66,44,slow leaners
3839,28,10,33,71,47,slow leaners
3840,28,23,33,84,56,Average learners
3841,24,41,14,79,52,Average learners
3842,42,12,45,99,66,Average learners
3843,20,41,25,86,57,Average learners
3844,47,18,21,86,57,Average learners
3845,46,22,33,101,67,Average learners
3846,39,34,28,101,67,Average learners
3847,38,28,42,108,72,fast learners
3848,40,48,10,98,65,Average learners
3849,34,33,49,116,77,fast learners
3850,13,28,15,56,37,slow leaners
3851,37,30,19,86,57,Average learners
3852,37,39,23,99,66,Average learners
3853,22,36,33,91,60,Average learners
3854,21,25,17,63,42,slow leaners
3855,38,21,43,102,68,Average learners
3856,20,35,46,101,67,Average learners
3857,19,15,31,65,43,slow leaners
3858,12,41,33,86,57,Average learners
3859,22,34,23,79,52,Average learners
3860,12,43,12,67,44,slow leaners
3861,31,46,25,102,68,Average learners
3862,34,34,43,111,74,fast learners
3863,29,29,41,99,66,Average learners
3864,33,15,13,61,40,slow leaners
3865,21,32,37,90,60,Average learners
3866,21,44,20,85,56,Average learners
3867,17,45,32,94,62,Average learners
3868,15,37,37,89,59,Average learners
3869,25,30,28,83,55,Average learners
3870,13,13,41,67,44,slow leaners
3871,31,18,46,95,63,Average learners
3872,29,39,34,102,68,Average learners
3873,13,35,14,62,41,slow leaners
3874,16,48,43,107,71,fast learners
3875,29,36,21,86,57,Average learners
3876,23,37,11,71,47,slow leaners
3877,24,15,39,78,52,Average learners
3878,12,44,37,93,62,Average learners
3879,27,28,27,82,54,Average learners
3880,22,28,34,84,56,Average learners
3881,17,32,16,65,43,slow leaners
3882,45,35,25,105,70,fast learners
3883,40,40,12,92,61,Average learners
3884,30,31,28,89,59,Average learners
3885,49,23,16,88,58,Average learners
3886,15,36,14,65,43,slow leaners
3887,13,30,25,68,45,slow leaners
3888,12,25,27,64,42,slow leaners
3889,22,48,14,84,56,Average learners
3890,34,48,43,125,83,fast learners
3891,18,19,10,47,31,slow leaners
3892,37,38,25,100,66,Average learners
3893,45,10,47,102,68,Average learners
3894,21,22,22,65,43,slow leaners
3895,43,43,44,130,86,fast learners
3896,21,46,39,106,70,fast learners
3897,16,10,14,40,26,slow leaners
3898,49,38,11,98,65,Average learners
3899,49,48,24,121,80,fast learners
3900,10,29,43,82,54,Average learners
3901,35,10,35,80,53,Average learners
3902,15,19,37,71,47,slow leaners
3903,34,28,31,93,62,Average learners
3904,48,22,21,91,60,Average learners
3905,22,38,29,89,59,Average learners
3906,36,26,44,106,70,fast learners
3907,11,45,43,99,66,Average learners
3908,18,15,27,60,40,slow leaners
3909,14,20,11,45,30,slow leaners
3910,23,37,37,97,64,Average learners
3911,34,21,23,78,52,Average learners
3912,33,42,42,117,78,fast learners
3913,31,48,11,90,60,Average learners
3914,45,20,21,86,57,Average learners
3915,39,27,46,112,74,fast learners
3916,12,42,17,71,47,slow leaners
3917,15,44,20,79,52,Average learners
3918,26,13,11,50,33,slow leaners
3919,34,18,15,67,44,slow leaners
3920,47,46,44,137,91,fast learners
3921,44,40,46,130,86,fast learners
3922,44,28,18,90,60,Average learners
3923,49,18,47,114,76,fast learners
3924,42,24,30,96,64,Average learners
3925,16,29,40,85,56,Average learners
3926,43,16,28,87,58,Average learners
3927,14,30,34,78,52,Average learners
3928,18,26,43,87,58,Average learners
3929,21,37,23,81,54,Average learners
3930,14,12,27,53,35,slow leaners
3931,26,17,46,89,59,Average learners
3932,22,49,35,106,70,fast learners
3933,31,49,40,120,80,fast learners
3934,16,36,25,77,51,Average learners
3935,24,47,10,81,54,Average learners
3936,28,37,30,95,63,Average learners
3937,10,24,30,64,42,slow leaners
3938,41,31,27,99,66,Average learners
3939,38,42,19,99,66,Average learners
3940,31,49,30,110,73,fast learners
3941,36,35,23,94,62,Average learners
3942,40,21,29,90,60,Average learners
3943,19,36,22,77,51,Average learners
3944,29,48,20,97,64,Average learners
3945,33,24,37,94,62,Average learners
3946,28,30,31,89,59,Average learners
3947,15,33,36,84,56,Average learners
3948,38,46,24,108,72,fast learners
3949,10,13,18,41,27,slow leaners
3950,47,44,25,116,77,fast learners
3951,24,40,14,78,52,Average learners
3952,40,38,35,113,75,fast learners
3953,48,36,26,110,73,fast learners
3954,46,12,19,77,51,Average learners
3955,46,31,40,117,78,fast learners
3956,20,11,24,55,36,slow leaners
3957,25,31,28,84,56,Average learners
3958,42,10,23,75,50,Average learners
3959,33,24,34,91,60,Average learners
3960,17,10,30,57,38,slow leaners
3961,16,35,21,72,48,slow leaners
3962,40,11,25,76,50,Average learners
3963,45,48,24,117,78,fast learners
3964,31,37,35,103,68,Average learners
3965,25,47,17,89,59,Average learners
3966,13,29,20,62,41,slow leaners
3967,18,39,27,84,56,Average learners
3968,30,13,46,89,59,Average learners
3969,29,49,18,96,64,Average learners
3970,45,16,27,88,58,Average learners
3971,10,33,47,90,60,Average learners
3972,36,25,14,75,50,Average learners
3973,29,19,25,73,48,slow leaners
3974,31,29,29,89,59,Average learners
3975,39,14,43,96,64,Average learners
3976,13,13,16,42,28,slow leaners
3977,26,39,42,107,71,fast learners
3978,40,38,15,93,62,Average learners
3979,24,41,44,109,72,fast learners
3980,26,46,18,90,60,Average learners
3981,14,38,41,93,62,Average learners
3982,35,26,35,96,64,Average learners
3983,21,33,45,99,66,Average learners
3984,20,33,48,101,67,Average learners
3985,21,19,39,79,52,Average learners
3986,34,16,10,60,40,slow leaners
3987,48,12,46,106,70,fast learners
3988,45,11,47,103,68,Average learners
3989,48,46,14,108,72,fast learners
3990,46,42,30,118,78,fast learners
3991,35,32,27,94,62,Average learners
3992,24,49,23,96,64,Average learners
3993,46,26,26,98,65,Average learners
3994,23,37,44,104,69,Average learners
3995,41,37,35,113,75,fast learners
3996,44,28,41,113,75,fast learners
3997,17,11,47,75,50,Average learners
3998,47,36,10,93,62,Average learners
3999,39,40,27,106,70,fast learners
4000,47,30,10,87,58,Average learners
4001,12,25,49,86,57,Average learners
4002,15,19,30,64,42,slow leaners
4003,46,22,36,104,69,Average learners
4004,38,22,45,105,70,fast learners
4005,39,49,27,115,76,fast learners
4006,48,27,40,115,76,fast learners
4007,14,46,26,86,57,Average learners
4008,38,30,10,78,52,Average learners
4009,28,16,25,69,46,slow leaners
4010,20,36,44,100,66,Average learners
4011,11,21,23,55,36,slow leaners
4012,36,37,25,98,65,Average learners
4013,20,23,41,84,56,Average learners
4014,11,43,45,99,66,Average learners
4015,45,43,22,110,73,fast learners
4016,20,35,41,96,64,Average learners
4017,29,12,28,69,46,slow leaners
4018,42,24,27,93,62,Average learners
4019,48,48,49,145,96,fast learners
4020,10,36,41,87,58,Average learners
4021,38,10,12,60,40,slow leaners
4022,24,43,48,115,76,fast learners
4023,33,31,16,80,53,Average learners
4024,44,24,10,78,52,Average learners
4025,28,27,43,98,65,Average learners
4026,42,28,41,111,74,fast learners
4027,11,31,24,66,44,slow leaners
4028,41,39,16,96,64,Average learners
4029,44,30,16,90,60,Average learners
4030,40,10,17,67,44,slow leaners
4031,29,48,43,120,80,fast learners
4032,24,25,25,74,49,slow leaners
4033,42,27,18,87,58,Average learners
4034,29,21,22,72,48,slow leaners
4035,43,12,35,90,60,Average learners
4036,38,30,18,86,57,Average learners
4037,18,45,34,97,64,Average learners
4038,24,43,48,115,76,fast learners
4039,12,12,10,34,22,slow leaners
4040,35,21,10,66,44,slow leaners
4041,42,40,35,117,78,fast learners
4042,27,43,34,104,69,Average learners
4043,47,27,46,120,80,fast learners
4044,37,11,19,67,44,slow leaners
4045,31,26,20,77,51,Average learners
4046,13,31,25,69,46,slow leaners
4047,37,33,33,103,68,Average learners
4048,37,35,45,117,78,fast learners
4049,32,12,29,73,48,slow leaners
4050,23,41,35,99,66,Average learners
4051,34,38,13,85,56,Average learners
4052,35,21,25,81,54,Average learners
4053,38,31,19,88,58,Average learners
4054,24,46,25,95,63,Average learners
4055,28,15,31,74,49,slow leaners
4056,22,36,41,99,66,Average learners
4057,46,44,41,131,87,fast learners
4058,26,17,17,60,40,slow leaners
4059,31,11,35,77,51,Average learners
4060,14,11,14,39,26,slow leaners
4061,16,49,38,103,68,Average learners
4062,37,33,24,94,62,Average learners
4063,30,12,31,73,48,slow leaners
4064,21,32,12,65,43,slow leaners
4065,16,17,19,52,34,slow leaners
4066,14,37,31,82,54,Average learners
4067,22,14,33,69,46,slow leaners
4068,11,46,33,90,60,Average learners
4069,29,35,15,79,52,Average learners
4070,42,43,15,100,66,Average learners
4071,44,49,17,110,73,fast learners
4072,40,14,41,95,63,Average learners
4073,33,38,28,99,66,Average learners
4074,31,32,14,77,51,Average learners
4075,32,22,41,95,63,Average learners
4076,22,46,32,100,66,Average learners
4077,33,39,21,93,62,Average learners
4078,13,35,28,76,50,Average learners
4079,18,17,28,63,42,slow leaners
4080,10,46,28,84,56,Average learners
4081,38,16,35,89,59,Average learners
4082,11,18,27,56,37,slow leaners
4083,35,17,30,82,54,Average learners
4084,35,40,23,98,65,Average learners
4085,22,15,14,51,34,slow leaners
4086,26,17,12,55,36,slow leaners
4087,27,26,33,86,57,Average learners
4088,32,28,15,75,50,Average learners
4089,22,36,29,87,58,Average learners
4090,49,11,42,102,68,Average learners
4091,25,34,24,83,55,Average learners
4092,35,39,38,112,74,fast learners
4093,35,26,10,71,47,slow leaners
4094,11,40,17,68,45,slow leaners
4095,48,39,15,102,68,Average learners
4096,43,14,31,88,58,Average learners
4097,25,23,27,75,50,Average learners
4098,38,47,19,104,69,Average learners
4099,24,32,49,105,70,fast learners
4100,42,30,44,116,77,fast learners
4101,45,28,37,110,73,fast learners
4102,17,17,22,56,37,slow leaners
4103,48,14,15,77,51,Average learners
4104,17,23,37,77,51,Average learners
4105,29,31,48,108,72,fast learners
4106,22,18,10,50,33,slow leaners
4107,37,16,41,94,62,Average learners
4108,43,44,18,105,70,fast learners
4109,44,12,29,85,56,Average learners
4110,27,35,10,72,48,slow leaners
4111,18,17,32,67,44,slow leaners
4112,34,46,26,106,70,fast learners
4113,15,13,27,55,36,slow leaners
4114,47,39,49,135,90,fast learners
4115,28,10,48,86,57,Average learners
4116,41,44,23,108,72,fast learners
4117,36,44,38,118,78,fast learners
4118,22,20,23,65,43,slow leaners
4119,48,23,29,100,66,Average learners
4120,47,17,40,104,69,Average learners
4121,42,36,24,102,68,Average learners
4122,23,36,28,87,58,Average learners
4123,12,26,49,87,58,Average learners
4124,37,41,15,93,62,Average learners
4125,15,24,36,75,50,Average learners
4126,31,29,47,107,71,fast learners
4127,28,24,19,71,47,slow leaners
4128,44,10,49,103,68,Average learners
4129,27,20,16,63,42,slow leaners
4130,23,14,32,69,46,slow leaners
4131,46,27,23,96,64,Average learners
4132,45,48,33,126,84,fast learners
4133,33,34,38,105,70,fast learners
4134,36,15,48,99,66,Average learners
4135,42,43,30,115,76,fast learners
4136,38,25,22,85,56,Average learners
4137,27,28,34,89,59,Average learners
4138,15,12,22,49,32,slow leaners
4139,49,27,25,101,67,Average learners
4140,27,38,19,84,56,Average learners
4141,38,22,21,81,54,Average learners
4142,13,29,28,70,46,slow leaners
4143,14,40,40,94,62,Average learners
4144,29,39,32,100,66,Average learners
4145,25,44,18,87,58,Average learners
4146,19,35,19,73,48,slow leaners
4147,36,31,18,85,56,Average learners
4148,21,38,20,79,52,Average learners
4149,34,43,11,88,58,Average learners
4150,40,14,38,92,61,Average learners
4151,20,10,16,46,30,slow leaners
4152,18,47,11,76,50,Average learners
4153,16,26,16,58,38,slow leaners
4154,29,19,45,93,62,Average learners
4155,10,20,23,53,35,slow leaners
4156,28,49,11,88,58,Average learners
4157,22,47,43,112,74,fast learners
4158,45,46,31,122,81,fast learners
4159,14,20,16,50,33,slow leaners
4160,24,15,38,77,51,Average learners
4161,10,18,42,70,46,slow leaners
4162,35,11,37,83,55,Average learners
4163,47,44,13,104,69,Average learners
4164,20,33,28,81,54,Average learners
4165,30,34,16,80,53,Average learners
4166,46,31,35,112,74,fast learners
4167,21,29,36,86,57,Average learners
4168,39,34,25,98,65,Average learners
4169,25,10,48,83,55,Average learners
4170,43,13,13,69,46,slow leaners
4171,40,24,14,78,52,Average learners
4172,25,46,26,97,64,Average learners
4173,19,48,28,95,63,Average learners
4174,28,19,18,65,43,slow leaners
4175,32,10,33,75,50,Average learners
4176,49,47,44,140,93,fast learners
4177,45,12,23,80,53,Average learners
4178,30,42,21,93,62,Average learners
4179,21,49,32,102,68,Average learners
4180,20,45,19,84,56,Average learners
4181,19,39,28,86,57,Average learners
4182,36,23,25,84,56,Average learners
4183,36,37,42,115,76,fast learners
4184,33,32,47,112,74,fast learners
4185,42,30,46,118,78,fast learners
4186,41,14,41,96,64,Average learners
4187,41,38,44,123,82,fast learners
4188,42,46,44,132,88,fast learners
4189,34,30,43,107,71,fast learners
4190,37,41,32,110,73,fast learners
4191,18,14,31,63,42,slow leaners
4192,39,35,28,102,68,Average learners
4193,40,49,47,136,90,fast learners
4194,44,48,11,103,68,Average learners
4195,40,26,43,109,72,fast learners
4196,38,16,35,89,59,Average learners
4197,13,16,44,73,48,slow leaners
4198,37,20,17,74,49,slow leaners
4199,29,26,18,73,48,slow leaners
4200,17,22,48,87,58,Average learners
4201,26,14,27,67,44,slow leaners
4202,19,33,17,69,46,slow leaners
4203,35,15,19,69,46,slow leaners
4204,13,48,40,101,67,Average learners
4205,36,37,38,111,74,fast learners
4206,47,37,17,101,67,Average learners
4207,39,32,38,109,72,fast learners
4208,34,14,10,58,38,slow leaners
4209,35,20,32,87,58,Average learners
4210,49,44,41,134,89,fast learners
4211,25,19,12,56,37,slow leaners
4212,33,22,25,80,53,Average learners
4213,41,49,25,115,76,fast learners
4214,24,30,40,94,62,Average learners
4215,15,40,35,90,60,Average learners
4216,28,32,36,96,64,Average learners
4217,47,47,14,108,72,fast learners
4218,17,38,35,90,60,Average learners
4219,35,13,22,70,46,slow leaners
4220,44,11,11,66,44,slow leaners
4221,28,20,18,66,44,slow leaners
4222,10,30,14,54,36,slow leaners
4223,16,21,38,75,50,Average learners
4224,48,26,31,105,70,fast learners
4225,35,30,21,86,57,Average learners
4226,16,14,27,57,38,slow leaners
4227,11,17,40,68,45,slow leaners
4228,48,32,45,125,83,fast learners
4229,28,44,28,100,66,Average learners
4230,27,43,38,108,72,fast learners
4231,46,45,45,136,90,fast learners
4232,21,15,20,56,37,slow leaners
4233,38,15,49,102,68,Average learners
4234,34,48,45,127,84,fast learners
4235,16,34,14,64,42,slow leaners
4236,34,10,33,77,51,Average learners
4237,23,47,38,108,72,fast learners
4238,48,27,39,114,76,fast learners
4239,48,49,45,142,94,fast learners
4240,17,35,18,70,46,slow leaners
4241,11,27,12,50,33,slow leaners
4242,34,14,13,61,40,slow leaners
4243,29,21,26,76,50,Average learners
4244,43,40,22,105,70,fast learners
4245,28,19,37,84,56,Average learners
4246,44,45,35,124,82,fast learners
4247,23,49,42,114,76,fast learners
4248,15,36,18,69,46,slow leaners
4249,37,43,38,118,78,fast learners
4250,37,20,38,95,63,Average learners
4251,12,16,38,66,44,slow leaners
4252,44,44,46,134,89,fast learners
4253,30,12,27,69,46,slow leaners
4254,36,17,41,94,62,Average learners
4255,19,13,28,60,40,slow leaners
4256,10,27,10,47,31,slow leaners
4257,28,15,20,63,42,slow leaners
4258,45,41,35,121,80,fast learners
4259,42,29,32,103,68,Average learners
4260,41,27,42,110,73,fast learners
4261,41,31,45,117,78,fast learners
4262,43,34,45,122,81,fast learners
4263,36,29,25,90,60,Average learners
4264,47,18,41,106,70,fast learners
4265,15,15,35,65,43,slow leaners
4266,40,24,18,82,54,Average learners
4267,27,48,25,100,66,Average learners
4268,45,11,36,92,61,Average learners
4269,10,46,24,80,53,Average learners
4270,46,12,21,79,52,Average learners
4271,32,49,11,92,61,Average learners
4272,40,14,14,68,45,slow leaners
4273,24,11,33,68,45,slow leaners
4274,39,44,19,102,68,Average learners
4275,23,24,26,73,48,slow leaners
4276,40,43,34,117,78,fast learners
4277,10,33,19,62,41,slow leaners
4278,49,48,44,141,94,fast learners
4279,20,36,20,76,50,Average learners
4280,33,46,43,122,81,fast learners
4281,21,23,48,92,61,Average learners
4282,14,47,13,74,49,slow leaners
4283,27,20,39,86,57,Average learners
4284,34,24,19,77,51,Average learners
4285,46,25,41,112,74,fast learners
4286,41,23,23,87,58,Average learners
4287,13,34,38,85,56,Average learners
4288,22,36,11,69,46,slow leaners
4289,27,17,42,86,57,Average learners
4290,49,22,48,119,79,fast learners
4291,17,31,13,61,40,slow leaners
4292,12,49,29,90,60,Average learners
4293,47,42,30,119,79,fast learners
4294,43,26,30,99,66,Average learners
4295,33,49,11,93,62,Average learners
4296,29,12,40,81,54,Average learners
4297,28,16,21,65,43,slow leaners
4298,21,12,41,74,49,slow leaners
4299,12,28,35,75,50,Average learners
4300,19,49,41,109,72,fast learners
4301,25,43,32,100,66,Average learners
4302,15,34,39,88,58,Average learners
4303,13,38,24,75,50,Average learners
4304,43,12,17,72,48,slow leaners
4305,13,21,11,45,30,slow leaners
4306,21,16,15,52,34,slow leaners
4307,43,37,21,101,67,Average learners
4308,20,30,48,98,65,Average learners
4309,44,41,23,108,72,fast learners
4310,12,44,49,105,70,fast learners
4311,27,32,44,103,68,Average learners
4312,37,41,47,125,83,fast learners
4313,29,41,11,81,54,Average learners
4314,19,23,16,58,38,slow leaners
4315,14,12,21,47,31,slow leaners
4316,31,34,44,109,72,fast learners
4317,28,47,46,121,80,fast learners
4318,16,34,25,75,50,Average learners
4319,44,43,42,129,86,fast learners
4320,15,32,20,67,44,slow leaners
4321,14,36,22,72,48,slow leaners
4322,18,11,19,48,32,slow leaners
4323,43,16,12,71,47,slow leaners
4324,45,22,23,90,60,Average learners
4325,12,14,28,54,36,slow leaners
4326,49,36,19,104,69,Average learners
4327,24,32,42,98,65,Average learners
4328,25,47,19,91,60,Average learners
4329,21,27,48,96,64,Average learners
4330,42,24,46,112,74,fast learners
4331,21,37,45,103,68,Average learners
4332,10,43,48,101,67,Average learners
4333,49,24,35,108,72,fast learners
4334,27,23,38,88,58,Average learners
4335,21,32,30,83,55,Average learners
4336,43,40,10,93,62,Average learners
4337,12,30,35,77,51,Average learners
4338,27,28,28,83,55,Average learners
4339,31,34,44,109,72,fast learners
4340,25,14,33,72,48,slow leaners
4341,41,48,35,124,82,fast learners
4342,23,45,31,99,66,Average learners
4343,47,38,14,99,66,Average learners
4344,42,23,45,110,73,fast learners
4345,40,47,41,128,85,fast learners
4346,31,25,41,97,64,Average learners
4347,13,44,21,78,52,Average learners
4348,35,43,21,99,66,Average learners
4349,30,29,27,86,57,Average learners
4350,44,33,34,111,74,fast learners
4351,29,42,15,86,57,Average learners
4352,25,25,33,83,55,Average learners
4353,43,26,22,91,60,Average learners
4354,36,18,21,75,50,Average learners
4355,23,19,14,56,37,slow leaners
4356,45,33,46,124,82,fast learners
4357,24,42,17,83,55,Average learners
4358,31,11,19,61,40,slow leaners
4359,14,32,13,59,39,slow leaners
4360,13,10,34,57,38,slow leaners
4361,14,31,34,79,52,Average learners
4362,21,40,16,77,51,Average learners
4363,28,33,46,107,71,fast learners
4364,23,41,42,106,70,fast learners
4365,49,19,17,85,56,Average learners
4366,25,15,32,72,48,slow leaners
4367,26,49,31,106,70,fast learners
4368,22,48,16,86,57,Average learners
4369,33,42,10,85,56,Average learners
4370,35,16,35,86,57,Average learners
4371,21,20,36,77,51,Average learners
4372,39,38,42,119,79,fast learners
4373,44,17,17,78,52,Average learners
4374,35,36,11,82,54,Average learners
4375,25,48,23,96,64,Average learners
4376,37,27,32,96,64,Average learners
4377,44,49,39,132,88,fast learners
4378,16,12,40,68,45,slow leaners
4379,35,11,43,89,59,Average learners
4380,11,25,27,63,42,slow leaners
4381,25,16,40,81,54,Average learners
4382,40,47,45,132,88,fast learners
4383,18,15,41,74,49,slow leaners
4384,31,17,46,94,62,Average learners
4385,32,26,43,101,67,Average learners
4386,46,40,16,102,68,Average learners
4387,35,27,21,83,55,Average learners
4388,49,45,29,123,82,fast learners
4389,17,44,27,88,58,Average learners
4390,10,25,13,48,32,slow leaners
4391,35,22,11,68,45,slow leaners
4392,30,12,32,74,49,slow leaners
4393,32,34,22,88,58,Average learners
4394,24,17,47,88,58,Average learners
4395,18,48,22,88,58,Average learners
4396,29,22,21,72,48,slow leaners
4397,35,12,47,94,62,Average learners
4398,45,36,28,109,72,fast learners
4399,36,47,17,100,66,Average learners
4400,15,13,39,67,44,slow leaners
4401,30,42,14,86,57,Average learners
4402,21,31,32,84,56,Average learners
4403,33,37,26,96,64,Average learners
4404,29,48,24,101,67,Average learners
4405,33,13,24,70,46,slow leaners
4406,27,28,46,101,67,Average learners
4407,15,18,30,63,42,slow leaners
4408,41,17,10,68,45,slow leaners
4409,18,25,25,68,45,slow leaners
4410,43,31,18,92,61,Average learners
4411,27,30,46,103,68,Average learners
4412,33,34,47,114,76,fast learners
4413,15,11,47,73,48,slow leaners
4414,22,12,38,72,48,slow leaners
4415,39,33,48,120,80,fast learners
4416,14,45,48,107,71,fast learners
4417,25,20,42,87,58,Average learners
4418,37,28,19,84,56,Average learners
4419,25,36,16,77,51,Average learners
4420,45,24,10,79,52,Average learners
4421,45,23,13,81,54,Average learners
4422,48,45,42,135,90,fast learners
4423,14,29,37,80,53,Average learners
4424,30,15,17,62,41,slow leaners
4425,48,36,12,96,64,Average learners
4426,46,14,27,87,58,Average learners
4427,37,31,44,112,74,fast learners
4428,29,20,15,64,42,slow leaners
4429,41,23,18,82,54,Average learners
4430,13,29,25,67,44,slow leaners
4431,41,20,40,101,67,Average learners
4432,24,11,17,52,34,slow leaners
4433,18,16,38,72,48,slow leaners
4434,46,36,14,96,64,Average learners
4435,45,23,40,108,72,fast learners
4436,46,42,26,114,76,fast learners
4437,30,32,22,84,56,Average learners
4438,20,14,13,47,31,slow leaners
4439,15,41,38,94,62,Average learners
4440,42,22,14,78,52,Average learners
4441,39,37,45,121,80,fast learners
4442,17,17,31,65,43,slow leaners
4443,49,40,21,110,73,fast learners
4444,18,32,45,95,63,Average learners
4445,49,34,45,128,85,fast learners
4446,45,31,16,92,61,Average learners
4447,44,39,44,127,84,fast learners
4448,39,24,32,95,63,Average learners
4449,49,26,16,91,60,Average learners
4450,25,14,25,64,42,slow leaners
4451,21,39,16,76,50,Average learners
4452,25,34,42,101,67,Average learners
4453,39,36,11,86,57,Average learners
4454,14,48,30,92,61,Average learners
4455,39,16,47,102,68,Average learners
4456,31,37,22,90,60,Average learners
4457,10,36,49,95,63,Average learners
4458,29,31,31,91,60,Average learners
4459,34,41,40,115,76,fast learners
4460,12,48,40,100,66,Average learners
4461,49,34,29,112,74,fast learners
4462,49,27,27,103,68,Average learners
4463,20,15,16,51,34,slow leaners
4464,20,47,14,81,54,Average learners
4465,28,19,16,63,42,slow leaners
4466,11,26,31,68,45,slow leaners
4467,35,23,43,101,67,Average learners
4468,24,23,12,59,39,slow leaners
4469,31,38,19,88,58,Average learners
4470,37,17,47,101,67,Average learners
4471,45,30,30,105,70,fast learners
4472,17,18,26,61,40,slow leaners
4473,18,47,19,84,56,Average learners
4474,10,36,39,85,56,Average learners
4475,48,31,49,128,85,fast learners
4476,19,29,30,78,52,Average learners
4477,17,38,34,89,59,Average learners
4478,40,17,36,93,62,Average learners
4479,43,15,47,105,70,fast learners
4480,13,18,39,70,46,slow leaners
4481,24,28,17,69,46,slow leaners
4482,38,49,21,108,72,fast learners
4483,28,19,44,91,60,Average learners
4484,19,31,45,95,63,Average learners
4485,40,43,17,100,66,Average learners
4486,13,40,35,88,58,Average learners
4487,26,49,27,102,68,Average learners
4488,25,11,44,80,53,Average learners
4489,23,36,30,89,59,Average learners
4490,42,29,20,91,60,Average learners
4491,43,40,36,119,79,fast learners
4492,36,44,36,116,77,fast learners
4493,45,49,26,120,80,fast learners
4494,21,12,40,73,48,slow leaners
4495,34,20,23,77,51,Average learners
4496,46,38,39,123,82,fast learners
4497,26,46,15,87,58,Average learners
4498,30,41,38,109,72,fast learners
4499,18,17,16,51,34,slow leaners
4500,10,11,40,61,40,slow leaners
4501,24,11,25,60,40,slow leaners
4502,19,22,14,55,36,slow leaners
4503,35,30,19,84,56,Average learners
4504,14,26,18,58,38,slow leaners
4505,46,25,12,83,55,Average learners
4506,21,45,20,86,57,Average learners
4507,33,22,34,89,59,Average learners
4508,17,32,24,73,48,slow leaners
4509,47,34,23,104,69,Average learners
4510,14,14,20,48,32,slow leaners
4511,33,15,10,58,38,slow leaners
4512,14,10,24,48,32,slow leaners
4513,47,39,45,131,87,fast learners
4514,39,10,24,73,48,slow leaners
4515,34,39,47,120,80,fast learners
4516,17,43,17,77,51,Average learners
4517,48,43,20,111,74,fast learners
4518,42,27,35,104,69,Average learners
4519,47,42,21,110,73,fast learners
4520,42,12,15,69,46,slow leaners
4521,23,48,37,108,72,fast learners
4522,10,30,30,70,46,slow leaners
4523,31,24,31,86,57,Average learners
4524,28,14,14,56,37,slow leaners
4525,35,46,41,122,81,fast learners
4526,41,18,38,97,64,Average learners
4527,32,39,38,109,72,fast learners
4528,44,27,46,117,78,fast learners
4529,39,41,17,97,64,Average learners
4530,41,46,46,133,88,fast learners
4531,28,16,43,87,58,Average learners
4532,26,42,19,87,58,Average learners
4533,45,11,17,73,48,slow leaners
4534,47,28,11,86,57,Average learners
4535,49,40,28,117,78,fast learners
4536,21,18,40,79,52,Average learners
4537,18,26,16,60,40,slow leaners
4538,38,32,31,101,67,Average learners
4539,34,45,40,119,79,fast learners
4540,24,19,27,70,46,slow leaners
4541,42,28,26,96,64,Average learners
4542,29,48,46,123,82,fast learners
4543,32,15,27,74,49,slow leaners
4544,16,29,13,58,38,slow leaners
4545,33,24,47,104,69,Average learners
4546,46,41,47,134,89,fast learners
4547,13,46,18,77,51,Average learners
4548,30,40,43,113,75,fast learners
4549,32,20,20,72,48,slow leaners
4550,18,16,31,65,43,slow leaners
4551,44,12,10,66,44,slow leaners
4552,19,27,27,73,48,slow leaners
4553,14,26,44,84,56,Average learners
4554,23,47,13,83,55,Average learners
4555,48,39,14,101,67,Average learners
4556,16,45,21,82,54,Average learners
4557,22,31,38,91,60,Average learners
4558,18,34,32,84,56,Average learners
4559,17,13,30,60,40,slow leaners
4560,44,47,23,114,76,fast learners
4561,15,18,45,78,52,Average learners
4562,12,16,49,77,51,Average learners
4563,38,45,46,129,86,fast learners
4564,18,39,35,92,61,Average learners
4565,23,15,12,50,33,slow leaners
4566,18,10,12,40,26,slow leaners
4567,31,25,34,90,60,Average learners
4568,43,38,16,97,64,Average learners
4569,12,47,40,99,66,Average learners
4570,19,38,23,80,53,Average learners
4571,24,34,43,101,67,Average learners
4572,23,23,20,66,44,slow leaners
4573,14,35,24,73,48,slow leaners
4574,22,43,18,83,55,Average learners
4575,33,40,27,100,66,Average learners
4576,13,23,49,85,56,Average learners
4577,49,44,21,114,76,fast learners
4578,16,18,42,76,50,Average learners
4579,34,32,48,114,76,fast learners
4580,30,38,30,98,65,Average learners
4581,24,30,23,77,51,Average learners
4582,38,32,46,116,77,fast learners
4583,20,26,20,66,44,slow leaners
4584,29,18,20,67,44,slow leaners
4585,43,36,39,118,78,fast learners
4586,26,43,37,106,70,fast learners
4587,23,29,28,80,53,Average learners
4588,20,10,43,73,48,slow leaners
4589,19,40,25,84,56,Average learners
4590,41,43,26,110,73,fast learners
4591,13,48,34,95,63,Average learners
4592,15,23,34,72,48,slow leaners
4593,32,32,26,90,60,Average learners
4594,12,15,40,67,44,slow leaners
4595,47,26,40,113,75,fast learners
4596,19,12,30,61,40,slow leaners
4597,30,25,37,92,61,Average learners
4598,14,37,40,91,60,Average learners
4599,45,46,27,118,78,fast learners
4600,40,22,45,107,71,fast learners
4601,36,33,12,81,54,Average learners
4602,21,24,16,61,40,slow leaners
4603,33,16,24,73,48,slow leaners
4604,22,37,47,106,70,fast learners
4605,18,23,14,55,36,slow leaners
4606,44,47,17,108,72,fast learners
4607,27,22,35,84,56,Average learners
4608,47,27,29,103,68,Average learners
4609,19,12,15,46,30,slow leaners
4610,24,48,29,101,67,Average learners
4611,33,42,29,104,69,Average learners
4612,34,13,17,64,42,slow leaners
4613,37,33,10,80,53,Average learners
4614,18,44,39,101,67,Average learners
4615,31,19,22,72,48,slow leaners
4616,11,37,25,73,48,slow leaners
4617,48,16,25,89,59,Average learners
4618,25,49,10,84,56,Average learners
4619,27,42,18,87,58,Average learners
4620,23,37,19,79,52,Average learners
4621,39,33,47,119,79,fast learners
4622,35,33,31,99,66,Average learners
4623,20,16,15,51,34,slow leaners
4624,16,45,12,73,48,slow leaners
4625,24,10,37,71,47,slow leaners
4626,30,39,17,86,57,Average learners
4627,27,36,37,100,66,Average learners
4628,46,21,39,106,70,fast learners
4629,48,24,23,95,63,Average learners
4630,32,48,38,118,78,fast learners
4631,36,46,26,108,72,fast learners
4632,26,27,33,86,57,Average learners
4633,17,48,17,82,54,Average learners
4634,29,21,17,67,44,slow leaners
4635,33,48,28,109,72,fast learners
4636,17,45,49,111,74,fast learners
4637,36,13,21,70,46,slow leaners
4638,35,20,15,70,46,slow leaners
4639,14,30,46,90,60,Average learners
4640,44,39,43,126,84,fast learners
4641,48,15,17,80,53,Average learners
4642,29,47,23,99,66,Average learners
4643,26,13,11,50,33,slow leaners
4644,41,29,39,109,72,fast learners
4645,24,43,26,93,62,Average learners
4646,22,36,45,103,68,Average learners
4647,33,21,45,99,66,Average learners
4648,27,43,34,104,69,Average learners
4649,32,36,10,78,52,Average learners
4650,43,32,33,108,72,fast learners
4651,26,15,33,74,49,slow leaners
4652,27,23,41,91,60,Average learners
4653,11,13,39,63,42,slow leaners
4654,49,49,29,127,84,fast learners
4655,24,18,13,55,36,slow leaners
4656,23,12,43,78,52,Average learners
4657,15,25,23,63,42,slow leaners
4658,38,18,34,90,60,Average learners
4659,26,41,28,95,63,Average learners
4660,24,40,40,104,69,Average learners
4661,42,30,35,107,71,fast learners
4662,47,37,22,106,70,fast learners
4663,48,44,15,107,71,fast learners
4664,44,30,15,89,59,Average learners
4665,35,16,13,64,42,slow leaners
4666,38,40,40,118,78,fast learners
4667,42,18,34,94,62,Average learners
4668,17,17,44,78,52,Average learners
4669,31,29,11,71,47,slow leaners
4670,35,15,21,71,47,slow leaners
4671,38,42,49,129,86,fast learners
4672,45,32,32,109,72,fast learners
4673,47,26,13,86,57,Average learners
4674,25,21,29,75,50,Average learners
4675,27,34,40,101,67,Average learners
4676,45,15,23,83,55,Average learners
4677,13,19,37,69,46,slow leaners
4678,17,20,44,81,54,Average learners
4679,47,19,17,83,55,Average learners
4680,18,46,38,102,68,Average learners
4681,31,23,28,82,54,Average learners
4682,36,22,41,99,66,Average learners
4683,34,35,21,90,60,Average learners
4684,49,17,44,110,73,fast learners
4685,18,37,16,71,47,slow leaners
4686,41,41,44,126,84,fast learners
4687,19,29,32,80,53,Average learners
4688,16,42,28,86,57,Average learners
4689,21,37,36,94,62,Average learners
4690,28,36,15,79,52,Average learners
4691,49,26,42,117,78,fast learners
4692,11,45,40,96,64,Average learners
4693,22,34,41,97,64,Average learners
4694,47,46,29,122,81,fast learners
4695,10,26,16,52,34,slow leaners
4696,15,37,25,77,51,Average learners
4697,30,47,35,112,74,fast learners
4698,48,14,27,89,59,Average learners
4699,43,29,26,98,65,Average learners
4700,28,16,39,83,55,Average learners
4701,15,42,32,89,59,Average learners
4702,49,26,42,117,78,fast learners
4703,20,10,34,64,42,slow leaners
4704,17,32,18,67,44,slow leaners
4705,19,43,34,96,64,Average learners
4706,28,42,38,108,72,fast learners
4707,47,11,43,101,67,Average learners
4708,45,38,23,106,70,fast learners
4709,45,17,36,98,65,Average learners
4710,24,27,38,89,59,Average learners
4711,39,26,21,86,57,Average learners
4712,22,44,38,104,69,Average learners
4713,41,49,41,131,87,fast learners
4714,43,41,31,115,76,fast learners
4715,15,38,48,101,67,Average learners
4716,42,20,48,110,73,fast learners
4717,18,35,29,82,54,Average learners
4718,48,16,14,78,52,Average learners
4719,40,28,24,92,61,Average learners
4720,37,34,42,113,75,fast learners
4721,28,21,18,67,44,slow leaners
4722,29,35,11,75,50,Average learners
4723,33,44,26,103,68,Average learners
4724,32,40,43,115,76,fast learners
4725,24,47,35,106,70,fast learners
4726,17,31,42,90,60,Average learners
4727,48,12,48,108,72,fast learners
4728,32,24,28,84,56,Average learners
4729,38,25,16,79,52,Average learners
4730,41,15,17,73,48,slow leaners
4731,49,20,14,83,55,Average learners
4732,19,48,33,100,66,Average learners
4733,23,42,36,101,67,Average learners
4734,49,10,12,71,47,slow leaners
4735,30,22,48,100,66,Average learners
4736,33,38,43,114,76,fast learners
4737,26,13,45,84,56,Average learners
4738,25,10,31,66,44,slow leaners
4739,40,22,43,105,70,fast learners
4740,34,35,36,105,70,fast learners
4741,27,26,48,101,67,Average learners
4742,35,49,48,132,88,fast learners
4743,11,30,31,72,48,slow leaners
4744,39,24,31,94,62,Average learners
4745,12,10,32,54,36,slow leaners
4746,46,43,12,101,67,Average learners
4747,45,26,31,102,68,Average learners
4748,44,34,32,110,73,fast learners
4749,10,16,39,65,43,slow leaners
4750,24,34,44,102,68,Average learners
4751,20,32,28,80,53,Average learners
4752,39,23,33,95,63,Average learners
4753,14,19,24,57,38,slow leaners
4754,29,15,31,75,50,Average learners
4755,24,13,38,75,50,Average learners
4756,16,49,42,107,71,fast learners
4757,31,40,44,115,76,fast learners
4758,42,46,29,117,78,fast learners
4759,11,29,40,80,53,Average learners
4760,35,34,24,93,62,Average learners
4761,36,33,22,91,60,Average learners
4762,13,15,13,41,27,slow leaners
4763,44,29,24,97,64,Average learners
4764,12,26,32,70,46,slow leaners
4765,20,40,43,103,68,Average learners
4766,32,22,18,72,48,slow leaners
4767,41,48,10,99,66,Average learners
4768,26,26,40,92,61,Average learners
4769,40,38,35,113,75,fast learners
4770,21,30,18,69,46,slow leaners
4771,37,39,27,103,68,Average learners
4772,10,29,37,76,50,Average learners
4773,40,42,10,92,61,Average learners
4774,23,12,21,56,37,slow leaners
4775,25,45,27,97,64,Average learners
4776,21,19,19,59,39,slow leaners
4777,16,44,16,76,50,Average learners
4778,12,11,13,36,24,slow leaners
4779,20,41,49,110,73,fast learners
4780,29,11,12,52,34,slow leaners
4781,20,34,14,68,45,slow leaners
4782,21,31,46,98,65,Average learners
4783,24,14,44,82,54,Average learners
4784,32,28,14,74,49,slow leaners
4785,12,13,31,56,37,slow leaners
4786,42,35,44,121,80,fast learners
4787,37,17,41,95,63,Average learners
4788,35,43,11,89,59,Average learners
4789,40,30,24,94,62,Average learners
4790,23,12,10,45,30,slow leaners
4791,30,29,17,76,50,Average learners
4792,43,44,26,113,75,fast learners
4793,44,28,23,95,63,Average learners
4794,17,46,28,91,60,Average learners
4795,44,26,32,102,68,Average learners
4796,11,18,36,65,43,slow leaners
4797,17,38,12,67,44,slow leaners
4798,38,39,20,97,64,Average learners
4799,27,27,27,81,54,Average learners
4800,20,31,30,81,54,Average learners
4801,29,37,12,78,52,Average learners
4802,31,39,47,117,78,fast learners
4803,36,23,34,93,62,Average learners
4804,27,44,31,102,68,Average learners
4805,20,34,49,103,68,Average learners
4806,18,40,27,85,56,Average learners
4807,45,29,17,91,60,Average learners
4808,33,47,16,96,64,Average learners
4809,37,22,32,91,60,Average learners
4810,16,33,32,81,54,Average learners
4811,34,14,41,89,59,Average learners
4812,38,19,31,88,58,Average learners
4813,14,39,16,69,46,slow leaners
4814,40,13,29,82,54,Average learners
4815,39,18,21,78,52,Average learners
4816,32,40,49,121,80,fast learners
4817,44,25,10,79,52,Average learners
4818,44,13,16,73,48,slow leaners
4819,16,11,34,61,40,slow leaners
4820,32,21,38,91,60,Average learners
4821,24,44,20,88,58,Average learners
4822,32,48,39,119,79,fast learners
4823,49,13,31,93,62,Average learners
4824,34,28,30,92,61,Average learners
4825,45,22,47,114,76,fast learners
4826,11,15,12,38,25,slow leaners
4827,30,23,31,84,56,Average learners
4828,31,47,42,120,80,fast learners
4829,46,47,40,133,88,fast learners
4830,40,47,19,106,70,fast learners
4831,42,29,33,104,69,Average learners
4832,24,48,17,89,59,Average learners
4833,28,16,17,61,40,slow leaners
4834,43,21,49,113,75,fast learners
4835,16,38,39,93,62,Average learners
4836,10,41,14,65,43,slow leaners
4837,32,34,11,77,51,Average learners
4838,48,12,38,98,65,Average learners
4839,27,44,20,91,60,Average learners
4840,20,32,23,75,50,Average learners
4841,18,33,21,72,48,slow leaners
4842,24,18,26,68,45,slow leaners
4843,41,16,46,103,68,Average learners
4844,39,25,11,75,50,Average learners
4845,21,44,20,85,56,Average learners
4846,48,44,36,128,85,fast learners
4847,17,44,42,103,68,Average learners
4848,19,37,16,72,48,slow leaners
4849,46,36,11,93,62,Average learners
4850,12,35,10,57,38,slow leaners
4851,11,47,46,104,69,Average learners
4852,48,36,28,112,74,fast learners
4853,12,38,32,82,54,Average learners
4854,26,16,32,74,49,slow leaners
4855,36,20,13,69,46,slow leaners
4856,39,41,23,103,68,Average learners
4857,48,11,35,94,62,Average learners
4858,11,47,31,89,59,Average learners
4859,26,29,49,104,69,Average learners
4860,22,32,45,99,66,Average learners
4861,47,11,37,95,63,Average learners
4862,22,13,29,64,42,slow leaners
4863,20,38,47,105,70,fast learners
4864,40,30,19,89,59,Average learners
4865,29,28,44,101,67,Average learners
4866,23,26,33,82,54,Average learners
4867,40,37,29,106,70,fast learners
4868,25,37,33,95,63,Average learners
4869,25,37,35,97,64,Average learners
4870,49,18,22,89,59,Average learners
4871,39,15,16,70,46,slow leaners
4872,22,46,34,102,68,Average learners
4873,10,18,37,65,43,slow leaners
4874,47,13,12,72,48,slow leaners
4875,12,20,32,64,42,slow leaners
4876,31,36,22,89,59,Average learners
4877,27,33,41,101,67,Average learners
4878,13,37,31,81,54,Average learners
4879,16,22,30,68,45,slow leaners
4880,33,10,22,65,43,slow leaners
4881,41,15,44,100,66,Average learners
4882,45,16,40,101,67,Average learners
4883,24,32,36,92,61,Average learners
4884,17,32,21,70,46,slow leaners
4885,38,41,42,121,80,fast learners
4886,37,20,40,97,64,Average learners
4887,20,19,29,68,45,slow leaners
4888,42,15,23,80,53,Average learners
4889,19,12,49,80,53,Average learners
4890,26,45,25,96,64,Average learners
4891,38,15,31,84,56,Average learners
4892,10,19,31,60,40,slow leaners
4893,48,12,49,109,72,fast learners
4894,11,28,31,70,46,slow leaners
4895,47,36,44,127,84,fast learners
4896,21,44,24,89,59,Average learners
4897,34,39,40,113,75,fast learners
4898,27,40,38,105,70,fast learners
4899,47,28,35,110,73,fast learners
4900,35,27,42,104,69,Average learners
4901,22,16,16,54,36,slow leaners
4902,46,35,10,91,60,Average learners
4903,18,48,24,90,60,Average learners
4904,43,36,49,128,85,fast learners
4905,29,34,45,108,72,fast learners
4906,26,23,19,68,45,slow leaners
4907,10,25,19,54,36,slow leaners
4908,13,40,11,64,42,slow leaners
4909,37,48,42,127,84,fast learners
4910,12,44,18,74,49,slow leaners
4911,21,32,30,83,55,Average learners
4912,20,35,39,94,62,Average learners
4913,40,24,43,107,71,fast learners
4914,25,46,31,102,68,Average learners
4915,42,25,33,100,66,Average learners
4916,40,12,16,68,45,slow leaners
4917,46,12,36,94,62,Average learners
4918,20,35,23,78,52,Average learners
4919,45,22,36,103,68,Average learners
4920,31,48,32,111,74,fast learners
4921,43,29,26,98,65,Average learners
4922,44,30,20,94,62,Average learners
4923,28,43,37,108,72,fast learners
4924,28,29,21,78,52,Average learners
4925,14,37,30,81,54,Average learners
4926,24,21,39,84,56,Average learners
4927,11,38,36,85,56,Average learners
4928,13,37,29,79,52,Average learners
4929,30,41,37,108,72,fast learners
4930,48,21,49,118,78,fast learners
4931,19,35,41,95,63,Average learners
4932,12,11,16,39,26,slow leaners
4933,20,13,34,67,44,slow leaners
4934,22,12,38,72,48,slow leaners
4935,14,18,14,46,30,slow leaners
4936,21,32,32,85,56,Average learners
4937,39,40,43,122,81,fast learners
4938,12,34,31,77,51,Average learners
4939,24,34,12,70,46,slow leaners
4940,44,19,24,87,58,Average learners
4941,31,29,27,87,58,Average learners
4942,21,11,40,72,48,slow leaners
4943,15,40,13,68,45,slow leaners
4944,48,47,39,134,89,fast learners
4945,42,35,18,95,63,Average learners
4946,36,42,15,93,62,Average learners
4947,38,41,45,124,82,fast learners
4948,19,15,28,62,41,slow leaners
4949,25,23,26,74,49,slow leaners
4950,19,30,38,87,58,Average learners
4951,43,46,47,136,90,fast learners
4952,34,29,23,86,57,Average learners
4953,13,10,19,42,28,slow leaners
4954,29,18,19,66,44,slow leaners
4955,47,29,38,114,76,fast learners
4956,39,12,44,95,63,Average learners
4957,35,29,45,109,72,fast learners
4958,48,35,39,122,81,fast learners
4959,10,10,27,47,31,slow leaners
4960,33,16,34,83,55,Average learners
4961,13,13,22,48,32,slow leaners
4962,25,16,18,59,39,slow leaners
4963,45,42,25,112,74,fast learners
4964,21,31,23,75,50,Average learners
4965,11,42,24,77,51,Average learners
4966,22,45,49,116,77,fast learners
4967,35,45,37,117,78,fast learners
4968,33,18,16,67,44,slow leaners
4969,14,34,25,73,48,slow leaners
4970,23,16,17,56,37,slow leaners
4971,46,41,41,128,85,fast learners
4972,37,46,44,127,84,fast learners
4973,27,45,30,102,68,Average learners
4974,16,33,28,77,51,Average learners
4975,34,36,23,93,62,Average learners
4976,36,40,32,108,72,fast learners
4977,40,19,40,99,66,Average learners
4978,37,14,46,97,64,Average learners
4979,32,21,49,102,68,Average learners
4980,24,18,46,88,58,Average learners
4981,10,37,20,67,44,slow leaners
4982,29,27,10,66,44,slow leaners
4983,21,14,13,48,32,slow leaners
4984,27,32,44,103,68,Average learners
4985,11,29,20,60,40,slow leaners
4986,21,46,11,78,52,Average learners
4987,45,31,49,125,83,fast learners
4988,29,48,21,98,65,Average learners
4989,46,28,34,108,72,fast learners
4990,21,20,41,82,54,Average learners
4991,47,41,41,129,86,fast learners
4992,27,26,27,80,53,Average learners
4993,24,32,11,67,44,slow leaners
4994,40,46,29,115,76,fast learners
4995,41,31,41,113,75,fast learners
4996,39,42,48,129,86,fast learners
4997,21,20,48,89,59,Average learners
4998,33,36,36,105,70,fast learners
4999,41,33,37,111,74,fast learners
5000,31,33,40,104,69,Average learners
5001,13,34,14,61,40,slow leaners
5002,12,23,12,47,31,slow leaners
5003,45,41,32,118,78,fast learners
5004,22,40,35,97,64,Average learners
5005,45,34,46,125,83,fast learners
5006,47,48,48,143,95,fast learners
5007,41,45,40,126,84,fast learners
5008,47,28,44,119,79,fast learners
5009,19,28,22,69,46,slow leaners
5010,45,17,30,92,61,Average learners
5011,14,34,44,92,61,Average learners
5012,24,10,40,74,49,slow leaners
5013,36,14,29,79,52,Average learners
5014,47,10,47,104,69,Average learners
5015,41,18,29,88,58,Average learners
5016,26,15,28,69,46,slow leaners
5017,24,23,12,59,39,slow leaners
5018,45,32,10,87,58,Average learners
5019,49,23,12,84,56,Average learners
5020,25,22,45,92,61,Average learners
5021,36,16,36,88,58,Average learners
5022,21,25,24,70,46,slow leaners
5023,14,28,12,54,36,slow leaners
5024,36,47,18,101,67,Average learners
5025,18,47,18,83,55,Average learners
5026,15,28,18,61,40,slow leaners
5027,28,28,19,75,50,Average learners
5028,11,27,21,59,39,slow leaners
5029,15,10,17,42,28,slow leaners
5030,25,44,24,93,62,Average learners
5031,12,42,46,100,66,Average learners
5032,26,34,30,90,60,Average learners
5033,39,16,41,96,64,Average learners
5034,21,20,42,83,55,Average learners
5035,49,31,28,108,72,fast learners
5036,28,25,12,65,43,slow leaners
5037,15,20,44,79,52,Average learners
5038,16,40,36,92,61,Average learners
5039,24,11,35,70,46,slow leaners
5040,17,11,19,47,31,slow leaners
5041,41,32,13,86,57,Average learners
5042,43,20,24,87,58,Average learners
5043,40,43,48,131,87,fast learners
5044,21,11,22,54,36,slow leaners
5045,28,33,20,81,54,Average learners
5046,10,34,16,60,40,slow leaners
5047,38,11,21,70,46,slow leaners
5048,35,17,49,101,67,Average learners
5049,43,45,48,136,90,fast learners
5050,40,40,36,116,77,fast learners
5051,22,44,43,109,72,fast learners
5052,19,33,38,90,60,Average learners
5053,35,44,19,98,65,Average learners
5054,27,36,10,73,48,slow leaners
5055,17,19,10,46,30,slow leaners
5056,44,28,35,107,71,fast learners
5057,46,23,27,96,64,Average learners
5058,43,19,29,91,60,Average learners
5059,11,16,47,74,49,slow leaners
5060,22,15,23,60,40,slow leaners
5061,29,17,34,80,53,Average learners
5062,23,16,28,67,44,slow leaners
5063,20,12,47,79,52,Average learners
5064,20,45,19,84,56,Average learners
5065,42,36,12,90,60,Average learners
5066,39,12,44,95,63,Average learners
5067,23,35,13,71,47,slow leaners
5068,36,40,48,124,82,fast learners
5069,23,12,31,66,44,slow leaners
5070,14,14,28,56,37,slow leaners
5071,36,11,24,71,47,slow leaners
5072,40,36,46,122,81,fast learners
5073,18,28,28,74,49,slow leaners
5074,38,46,46,130,86,fast learners
5075,43,44,25,112,74,fast learners
5076,12,16,48,76,50,Average learners
5077,36,29,31,96,64,Average learners
5078,14,32,30,76,50,Average learners
5079,33,49,16,98,65,Average learners
5080,29,44,46,119,79,fast learners
5081,20,18,31,69,46,slow leaners
5082,32,28,44,104,69,Average learners
5083,25,12,30,67,44,slow leaners
5084,47,31,29,107,71,fast learners
5085,40,32,22,94,62,Average learners
5086,49,15,33,97,64,Average learners
5087,38,17,21,76,50,Average learners
5088,37,16,34,87,58,Average learners
5089,27,30,38,95,63,Average learners
5090,18,43,19,80,53,Average learners
5091,27,18,12,57,38,slow leaners
5092,36,43,39,118,78,fast learners
5093,11,23,29,63,42,slow leaners
5094,24,43,28,95,63,Average learners
5095,10,44,10,64,42,slow leaners
5096,31,18,19,68,45,slow leaners
5097,26,35,44,105,70,fast learners
5098,46,12,23,81,54,Average learners
5099,28,39,25,92,61,Average learners
5100,48,40,16,104,69,Average learners
5101,24,18,29,71,47,slow leaners
5102,34,27,10,71,47,slow leaners
5103,20,22,41,83,55,Average learners
5104,16,45,15,76,50,Average learners
5105,37,24,12,73,48,slow leaners
5106,34,20,11,65,43,slow leaners
5107,24,48,16,88,58,Average learners
5108,46,25,25,96,64,Average learners
5109,26,27,48,101,67,Average learners
5110,21,21,17,59,39,slow leaners
5111,34,41,48,123,82,fast learners
5112,16,13,26,55,36,slow leaners
5113,48,20,32,100,66,Average learners
5114,15,35,32,82,54,Average learners
5115,31,47,15,93,62,Average learners
5116,27,45,45,117,78,fast learners
5117,21,38,36,95,63,Average learners
5118,21,42,32,95,63,Average learners
5119,23,23,31,77,51,Average learners
5120,13,45,18,76,50,Average learners
5121,23,15,13,51,34,slow leaners
5122,20,33,43,96,64,Average learners
5123,45,26,16,87,58,Average learners
5124,29,10,22,61,40,slow leaners
5125,27,41,13,81,54,Average learners
5126,37,37,39,113,75,fast learners
5127,41,31,19,91,60,Average learners
5128,43,34,11,88,58,Average learners
5129,15,12,38,65,43,slow leaners
5130,17,15,37,69,46,slow leaners
5131,47,16,14,77,51,Average learners
5132,45,32,13,90,60,Average learners
5133,46,25,34,105,70,fast learners
5134,16,49,48,113,75,fast learners
5135,39,44,21,104,69,Average learners
5136,35,40,14,89,59,Average learners
5137,20,16,48,84,56,Average learners
5138,20,19,49,88,58,Average learners
5139,29,26,27,82,54,Average learners
5140,11,39,10,60,40,slow leaners
5141,48,38,35,121,80,fast learners
5142,26,13,45,84,56,Average learners
5143,12,39,34,85,56,Average learners
5144,17,38,35,90,60,Average learners
5145,16,36,36,88,58,Average learners
5146,45,13,46,104,69,Average learners
5147,48,49,10,107,71,fast learners
5148,21,20,18,59,39,slow leaners
5149,13,21,49,83,55,Average learners
5150,48,41,26,115,76,fast learners
5151,36,32,36,104,69,Average learners
5152,38,28,40,106,70,fast learners
5153,12,46,32,90,60,Average learners
5154,38,41,15,94,62,Average learners
5155,15,47,17,79,52,Average learners
5156,35,22,48,105,70,fast learners
5157,18,25,33,76,50,Average learners
5158,31,34,34,99,66,Average learners
5159,13,17,22,52,34,slow leaners
5160,36,31,47,114,76,fast learners
5161,24,19,35,78,52,Average learners
5162,47,48,36,131,87,fast learners
5163,44,23,34,101,67,Average learners
5164,43,18,49,110,73,fast learners
5165,16,33,40,89,59,Average learners
5166,32,27,17,76,50,Average learners
5167,16,21,24,61,40,slow leaners
5168,46,47,40,133,88,fast learners
5169,43,14,18,75,50,Average learners
5170,29,11,46,86,57,Average learners
5171,30,33,39,102,68,Average learners
5172,43,32,11,86,57,Average learners
5173,31,47,18,96,64,Average learners
5174,31,10,48,89,59,Average learners
5175,11,40,40,91,60,Average learners
5176,37,23,33,93,62,Average learners
5177,26,18,15,59,39,slow leaners
5178,39,12,41,92,61,Average learners
5179,49,47,16,112,74,fast learners
5180,25,13,38,76,50,Average learners
5181,25,29,18,72,48,slow leaners
5182,12,26,40,78,52,Average learners
5183,11,27,15,53,35,slow leaners
5184,11,40,31,82,54,Average learners
5185,44,45,26,115,76,fast learners
5186,11,40,17,68,45,slow leaners
5187,45,36,44,125,83,fast learners
5188,31,47,24,102,68,Average learners
5189,28,13,17,58,38,slow leaners
5190,22,23,35,80,53,Average learners
5191,10,43,48,101,67,Average learners
5192,23,13,21,57,38,slow leaners
5193,21,25,23,69,46,slow leaners
5194,10,30,47,87,58,Average learners
5195,44,18,40,102,68,Average learners
5196,42,17,27,86,57,Average learners
5197,27,38,19,84,56,Average learners
5198,29,29,10,68,45,slow leaners
5199,37,42,35,114,76,fast learners
5200,15,25,14,54,36,slow leaners
5201,30,19,22,71,47,slow leaners
5202,24,13,35,72,48,slow leaners
5203,27,35,17,79,52,Average learners
5204,18,21,47,86,57,Average learners
5205,30,43,46,119,79,fast learners
5206,32,39,29,100,66,Average learners
5207,13,29,29,71,47,slow leaners
5208,14,22,18,54,36,slow leaners
5209,32,24,33,89,59,Average learners
5210,47,12,34,93,62,Average learners
5211,41,18,20,79,52,Average learners
5212,45,31,48,124,82,fast learners
5213,19,20,41,80,53,Average learners
5214,11,41,14,66,44,slow leaners
5215,29,43,35,107,71,fast learners
5216,11,12,32,55,36,slow leaners
5217,24,23,35,82,54,Average learners
5218,12,43,31,86,57,Average learners
5219,21,21,29,71,47,slow leaners
5220,48,28,13,89,59,Average learners
5221,27,20,27,74,49,slow leaners
5222,31,20,36,87,58,Average learners
5223,19,41,28,88,58,Average learners
5224,41,47,42,130,86,fast learners
5225,11,34,49,94,62,Average learners
5226,32,41,46,119,79,fast learners
5227,31,16,33,80,53,Average learners
5228,13,40,29,82,54,Average learners
5229,21,30,32,83,55,Average learners
5230,11,42,32,85,56,Average learners
5231,10,31,34,75,50,Average learners
5232,42,15,49,106,70,fast learners
5233,11,48,33,92,61,Average learners
5234,25,13,11,49,32,slow leaners
5235,36,43,32,111,74,fast learners
5236,33,37,34,104,69,Average learners
5237,34,49,31,114,76,fast learners
5238,18,14,24,56,37,slow leaners
5239,37,26,11,74,49,slow leaners
5240,42,49,33,124,82,fast learners
5241,25,26,12,63,42,slow leaners
5242,20,18,26,64,42,slow leaners
5243,46,21,15,82,54,Average learners
5244,16,22,20,58,38,slow leaners
5245,20,46,33,99,66,Average learners
5246,22,24,17,63,42,slow leaners
5247,45,13,18,76,50,Average learners
5248,15,25,27,67,44,slow leaners
5249,42,10,29,81,54,Average learners
5250,22,29,29,80,53,Average learners
5251,38,43,44,125,83,fast learners
5252,38,27,18,83,55,Average learners
5253,17,14,26,57,38,slow leaners
5254,27,16,15,58,38,slow leaners
5255,15,41,19,75,50,Average learners
5256,41,21,39,101,67,Average learners
5257,24,17,31,72,48,slow leaners
5258,13,16,36,65,43,slow leaners
5259,41,23,39,103,68,Average learners
5260,18,31,16,65,43,slow leaners
5261,10,14,33,57,38,slow leaners
5262,12,26,42,80,53,Average learners
5263,20,38,15,73,48,slow leaners
5264,23,27,47,97,64,Average learners
5265,26,32,15,73,48,slow leaners
5266,18,15,44,77,51,Average learners
5267,27,28,47,102,68,Average learners
5268,35,49,12,96,64,Average learners
5269,16,31,11,58,38,slow leaners
5270,35,31,20,86,57,Average learners
5271,39,38,38,115,76,fast learners
5272,32,41,38,111,74,fast learners
5273,10,23,16,49,32,slow leaners
5274,18,35,32,85,56,Average learners
5275,31,39,12,82,54,Average learners
5276,42,11,18,71,47,slow leaners
5277,30,30,37,97,64,Average learners
5278,48,32,48,128,85,fast learners
5279,38,47,27,112,74,fast learners
5280,44,46,16,106,70,fast learners
5281,11,26,28,65,43,slow leaners
5282,37,44,26,107,71,fast learners
5283,18,32,27,77,51,Average learners
5284,25,31,28,84,56,Average learners
5285,26,45,25,96,64,Average learners
5286,48,22,25,95,63,Average learners
5287,20,27,40,87,58,Average learners
5288,35,12,25,72,48,slow leaners
5289,18,22,25,65,43,slow leaners
5290,42,11,14,67,44,slow leaners
5291,38,46,40,124,82,fast learners
5292,36,16,19,71,47,slow leaners
5293,46,42,26,114,76,fast learners
5294,20,26,45,91,60,Average learners
5295,14,27,39,80,53,Average learners
5296,46,48,22,116,77,fast learners
5297,39,24,26,89,59,Average learners
5298,14,41,13,68,45,slow leaners
5299,45,13,15,73,48,slow leaners
5300,41,22,16,79,52,Average learners
5301,28,29,46,103,68,Average learners
5302,12,32,12,56,37,slow leaners
5303,47,23,24,94,62,Average learners
5304,22,41,33,96,64,Average learners
5305,22,43,31,96,64,Average learners
5306,46,35,27,108,72,fast learners
5307,37,21,11,69,46,slow leaners
5308,33,42,27,102,68,Average learners
5309,16,41,30,87,58,Average learners
5310,11,41,41,93,62,Average learners
5311,36,17,38,91,60,Average learners
5312,15,11,29,55,36,slow leaners
5313,40,29,10,79,52,Average learners
5314,49,43,22,114,76,fast learners
5315,39,15,35,89,59,Average learners
5316,49,14,23,86,57,Average learners
5317,43,44,27,114,76,fast learners
5318,37,17,17,71,47,slow leaners
5319,39,45,34,118,78,fast learners
5320,34,40,36,110,73,fast learners
5321,11,41,35,87,58,Average learners
5322,36,45,46,127,84,fast learners
5323,29,12,22,63,42,slow leaners
5324,31,40,40,111,74,fast learners
5325,47,45,30,122,81,fast learners
5326,19,19,26,64,42,slow leaners
5327,39,34,44,117,78,fast learners
5328,14,43,49,106,70,fast learners
5329,42,37,20,99,66,Average learners
5330,35,47,24,106,70,fast learners
5331,18,38,22,78,52,Average learners
5332,39,25,41,105,70,fast learners
5333,48,17,38,103,68,Average learners
5334,23,29,42,94,62,Average learners
5335,36,24,48,108,72,fast learners
5336,45,17,48,110,73,fast learners
5337,19,45,38,102,68,Average learners
5338,42,21,33,96,64,Average learners
5339,14,27,25,66,44,slow leaners
5340,42,41,32,115,76,fast learners
5341,47,39,16,102,68,Average learners
5342,13,23,43,79,52,Average learners
5343,20,10,24,54,36,slow leaners
5344,10,29,33,72,48,slow leaners
5345,34,45,21,100,66,Average learners
5346,11,22,14,47,31,slow leaners
5347,23,48,40,111,74,fast learners
5348,34,31,23,88,58,Average learners
5349,12,25,27,64,42,slow leaners
5350,44,48,45,137,91,fast learners
5351,10,32,38,80,53,Average learners
5352,10,36,35,81,54,Average learners
5353,25,46,12,83,55,Average learners
5354,14,39,31,84,56,Average learners
5355,39,18,36,93,62,Average learners
5356,45,29,30,104,69,Average learners
5357,45,11,48,104,69,Average learners
5358,44,36,36,116,77,fast learners
5359,28,27,47,102,68,Average learners
5360,22,12,44,78,52,Average learners
5361,22,10,49,81,54,Average learners
5362,41,36,25,102,68,Average learners
5363,41,41,23,105,70,fast learners
5364,23,37,15,75,50,Average learners
5365,18,19,47,84,56,Average learners
5366,27,19,48,94,62,Average learners
5367,47,45,18,110,73,fast learners
5368,46,44,27,117,78,fast learners
5369,10,36,34,80,53,Average learners
5370,33,26,30,89,59,Average learners
5371,22,17,10,49,32,slow leaners
5372,32,40,22,94,62,Average learners
5373,46,46,22,114,76,fast learners
5374,13,44,10,67,44,slow leaners
5375,18,36,20,74,49,slow leaners
5376,36,40,33,109,72,fast learners
5377,28,14,32,74,49,slow leaners
5378,19,44,10,73,48,slow leaners
5379,48,38,19,105,70,fast learners
5380,49,28,25,102,68,Average learners
5381,25,26,25,76,50,Average learners
5382,37,18,33,88,58,Average learners
5383,21,23,23,67,44,slow leaners
5384,21,12,23,56,37,slow leaners
5385,18,18,32,68,45,slow leaners
5386,47,15,48,110,73,fast learners
5387,35,33,24,92,61,Average learners
5388,20,49,19,88,58,Average learners
5389,11,16,31,58,38,slow leaners
5390,35,13,32,80,53,Average learners
5391,43,30,32,105,70,fast learners
5392,38,17,46,101,67,Average learners
5393,39,15,22,76,50,Average learners
5394,21,31,12,64,42,slow leaners
5395,37,17,18,72,48,slow leaners
5396,15,43,22,80,53,Average learners
5397,18,40,41,99,66,Average learners
5398,17,44,31,92,61,Average learners
5399,39,21,29,89,59,Average learners
5400,43,33,17,93,62,Average learners
5401,45,12,43,100,66,Average learners
5402,17,40,48,105,70,fast learners
5403,10,39,21,70,46,slow leaners
5404,23,35,22,80,53,Average learners
5405,28,47,34,109,72,fast learners
5406,49,19,26,94,62,Average learners
5407,20,47,34,101,67,Average learners
5408,20,43,13,76,50,Average learners
5409,14,17,43,74,49,slow leaners
5410,41,31,13,85,56,Average learners
5411,22,26,22,70,46,slow leaners
5412,44,39,25,108,72,fast learners
5413,26,12,22,60,40,slow leaners
5414,38,12,36,86,57,Average learners
5415,40,37,34,111,74,fast learners
5416,22,36,17,75,50,Average learners
5417,14,42,29,85,56,Average learners
5418,37,31,16,84,56,Average learners
5419,21,44,39,104,69,Average learners
5420,13,49,36,98,65,Average learners
5421,20,24,38,82,54,Average learners
5422,14,27,29,70,46,slow leaners
5423,25,19,42,86,57,Average learners
5424,48,38,39,125,83,fast learners
5425,20,11,40,71,47,slow leaners
5426,11,33,43,87,58,Average learners
5427,41,35,12,88,58,Average learners
5428,28,10,23,61,40,slow leaners
5429,37,30,29,96,64,Average learners
5430,45,40,25,110,73,fast learners
5431,42,26,35,103,68,Average learners
5432,41,26,22,89,59,Average learners
5433,29,44,12,85,56,Average learners
5434,31,24,29,84,56,Average learners
5435,45,28,37,110,73,fast learners
5436,31,13,39,83,55,Average learners
5437,14,10,14,38,25,slow leaners
5438,34,13,45,92,61,Average learners
5439,41,20,25,86,57,Average learners
5440,24,39,49,112,74,fast learners
5441,25,43,14,82,54,Average learners
5442,14,17,32,63,42,slow leaners
5443,36,27,44,107,71,fast learners
5444,24,36,27,87,58,Average learners
5445,26,37,29,92,61,Average learners
5446,36,31,37,104,69,Average learners
5447,17,10,12,39,26,slow leaners
5448,10,24,30,64,42,slow leaners
5449,26,35,19,80,53,Average learners
5450,39,45,32,116,77,fast learners
5451,18,38,38,94,62,Average learners
5452,29,47,29,105,70,fast learners
5453,15,17,44,76,50,Average learners
5454,42,27,44,113,75,fast learners
5455,46,17,34,97,64,Average learners
5456,15,10,40,65,43,slow leaners
5457,15,45,32,92,61,Average learners
5458,49,32,39,120,80,fast learners
5459,13,29,25,67,44,slow leaners
5460,20,21,32,73,48,slow leaners
5461,31,10,38,79,52,Average learners
5462,24,24,42,90,60,Average learners
5463,25,36,47,108,72,fast learners
5464,38,46,48,132,88,fast learners
5465,40,38,49,127,84,fast learners
5466,17,33,15,65,43,slow leaners
5467,11,41,29,81,54,Average learners
5468,43,15,40,98,65,Average learners
5469,33,48,19,100,66,Average learners
5470,41,49,44,134,89,fast learners
5471,43,22,29,94,62,Average learners
5472,24,44,18,86,57,Average learners
5473,16,47,26,89,59,Average learners
5474,15,31,32,78,52,Average learners
5475,45,42,37,124,82,fast learners
5476,35,13,11,59,39,slow leaners
5477,43,29,28,100,66,Average learners
5478,33,29,47,109,72,fast learners
5479,42,11,19,72,48,slow leaners
5480,25,22,28,75,50,Average learners
5481,44,32,22,98,65,Average learners
5482,12,25,31,68,45,slow leaners
5483,28,21,21,70,46,slow leaners
5484,15,27,24,66,44,slow leaners
5485,12,34,27,73,48,slow leaners
5486,32,42,44,118,78,fast learners
5487,19,41,36,96,64,Average learners
5488,19,30,14,63,42,slow leaners
5489,28,14,25,67,44,slow leaners
5490,30,41,23,94,62,Average learners
5491,28,29,15,72,48,slow leaners
5492,48,43,34,125,83,fast learners
5493,42,17,16,75,50,Average learners
5494,48,37,46,131,87,fast learners
5495,37,37,18,92,61,Average learners
5496,32,44,15,91,60,Average learners
5497,47,36,31,114,76,fast learners
5498,26,21,11,58,38,slow leaners
5499,47,28,34,109,72,fast learners
5500,36,49,48,133,88,fast learners
5501,17,17,49,83,55,Average learners
5502,15,25,42,82,54,Average learners
5503,38,31,37,106,70,fast learners
5504,14,12,29,55,36,slow leaners
5505,31,40,15,86,57,Average learners
5506,38,34,23,95,63,Average learners
5507,49,46,14,109,72,fast learners
5508,20,36,29,85,56,Average learners
5509,20,20,18,58,38,slow leaners
5510,44,47,40,131,87,fast learners
5511,49,48,38,135,90,fast learners
5512,40,26,11,77,51,Average learners
5513,45,10,17,72,48,slow leaners
5514,18,10,36,64,42,slow leaners
5515,14,49,24,87,58,Average learners
5516,37,10,37,84,56,Average learners
5517,20,25,46,91,60,Average learners
5518,43,47,46,136,90,fast learners
5519,33,18,19,70,46,slow leaners
5520,31,35,49,115,76,fast learners
5521,37,38,33,108,72,fast learners
5522,35,26,18,79,52,Average learners
5523,28,30,17,75,50,Average learners
5524,35,46,43,124,82,fast learners
5525,35,27,36,98,65,Average learners
5526,18,35,10,63,42,slow leaners
5527,10,32,40,82,54,Average learners
5528,37,11,10,58,38,slow leaners
5529,39,19,21,79,52,Average learners
5530,11,24,43,78,52,Average learners
5531,43,33,10,86,57,Average learners
5532,15,28,44,87,58,Average learners
5533,15,33,40,88,58,Average learners
5534,19,37,46,102,68,Average learners
5535,42,33,17,92,61,Average learners
5536,16,26,20,62,41,slow leaners
5537,18,37,20,75,50,Average learners
5538,16,33,47,96,64,Average learners
5539,14,13,15,42,28,slow leaners
5540,15,18,49,82,54,Average learners
5541,25,29,12,66,44,slow leaners
5542,11,24,13,48,32,slow leaners
5543,15,15,16,46,30,slow leaners
5544,37,33,32,102,68,Average learners
5545,17,42,19,78,52,Average learners
5546,46,45,11,102,68,Average learners
5547,28,45,27,100,66,Average learners
5548,20,12,20,52,34,slow leaners
5549,47,49,18,114,76,fast learners
5550,43,36,12,91,60,Average learners
5551,34,37,49,120,80,fast learners
5552,49,20,26,95,63,Average learners
5553,35,17,16,68,45,slow leaners
5554,16,33,41,90,60,Average learners
5555,36,15,13,64,42,slow leaners
5556,26,18,24,68,45,slow leaners
5557,23,42,25,90,60,Average learners
5558,13,30,46,89,59,Average learners
5559,20,37,30,87,58,Average learners
5560,49,27,23,99,66,Average learners
5561,39,11,35,85,56,Average learners
5562,47,37,41,125,83,fast learners
5563,43,27,36,106,70,fast learners
5564,45,31,31,107,71,fast learners
5565,32,34,36,102,68,Average learners
5566,33,34,27,94,62,Average learners
5567,26,22,22,70,46,slow leaners
5568,26,32,11,69,46,slow leaners
5569,37,40,25,102,68,Average learners
5570,29,46,34,109,72,fast learners
5571,22,21,23,66,44,slow leaners
5572,14,32,47,93,62,Average learners
5573,27,43,45,115,76,fast learners
5574,40,45,44,129,86,fast learners
5575,43,25,28,96,64,Average learners
5576,16,16,10,42,28,slow leaners
5577,48,11,27,86,57,Average learners
5578,28,16,18,62,41,slow leaners
5579,46,16,11,73,48,slow leaners
5580,38,32,26,96,64,Average learners
5581,39,21,44,104,69,Average learners
5582,16,39,14,69,46,slow leaners
5583,31,33,31,95,63,Average learners
5584,48,38,48,134,89,fast learners
5585,13,27,17,57,38,slow leaners
5586,44,47,17,108,72,fast learners
5587,19,23,41,83,55,Average learners
5588,45,23,20,88,58,Average learners
5589,36,37,34,107,71,fast learners
5590,46,41,43,130,86,fast learners
5591,10,17,17,44,29,slow leaners
5592,19,10,23,52,34,slow leaners
5593,39,23,46,108,72,fast learners
5594,23,44,29,96,64,Average learners
5595,28,27,23,78,52,Average learners
5596,23,22,21,66,44,slow leaners
5597,43,12,17,72,48,slow leaners
5598,36,35,43,114,76,fast learners
5599,29,21,39,89,59,Average learners
5600,23,39,22,84,56,Average learners
5601,16,33,30,79,52,Average learners
5602,31,39,34,104,69,Average learners
5603,44,16,26,86,57,Average learners
5604,39,40,11,90,60,Average learners
5605,22,24,45,91,60,Average learners
5606,39,25,15,79,52,Average learners
5607,43,37,40,120,80,fast learners
5608,35,19,22,76,50,Average learners
5609,39,31,12,82,54,Average learners
5610,29,32,32,93,62,Average learners
5611,18,43,28,89,59,Average learners
5612,44,36,37,117,78,fast learners
5613,42,18,11,71,47,slow leaners
5614,41,23,36,100,66,Average learners
5615,29,16,17,62,41,slow leaners
5616,37,14,16,67,44,slow leaners
5617,35,36,43,114,76,fast learners
5618,37,31,46,114,76,fast learners
5619,26,19,44,89,59,Average learners
5620,35,23,32,90,60,Average learners
5621,37,49,28,114,76,fast learners
5622,47,23,48,118,78,fast learners
5623,41,10,35,86,57,Average learners
5624,23,21,36,80,53,Average learners
5625,33,49,12,94,62,Average learners
5626,14,12,43,69,46,slow leaners
5627,30,43,18,91,60,Average learners
5628,29,31,23,83,55,Average learners
5629,40,33,12,85,56,Average learners
5630,12,24,10,46,30,slow leaners
5631,31,29,16,76,50,Average learners
5632,34,18,15,67,44,slow leaners
5633,29,36,28,93,62,Average learners
5634,14,35,39,88,58,Average learners
5635,34,30,10,74,49,slow leaners
5636,39,29,46,114,76,fast learners
5637,44,24,20,88,58,Average learners
5638,27,27,11,65,43,slow leaners
5639,28,32,26,86,57,Average learners
5640,29,46,48,123,82,fast learners
5641,16,17,25,58,38,slow leaners
5642,34,29,39,102,68,Average learners
5643,11,27,44,82,54,Average learners
5644,10,45,34,89,59,Average learners
5645,42,12,38,92,61,Average learners
5646,16,23,46,85,56,Average learners
5647,30,23,15,68,45,slow leaners
5648,18,29,23,70,46,slow leaners
5649,18,33,40,91,60,Average learners
5650,17,24,30,71,47,slow leaners
5651,13,35,10,58,38,slow leaners
5652,37,15,23,75,50,Average learners
5653,17,25,41,83,55,Average learners
5654,17,30,15,62,41,slow leaners
5655,34,24,22,80,53,Average learners
5656,14,14,36,64,42,slow leaners
5657,34,14,33,81,54,Average learners
5658,47,41,49,137,91,fast learners
5659,21,33,22,76,50,Average learners
5660,20,35,16,71,47,slow leaners
5661,45,34,20,99,66,Average learners
5662,46,37,40,123,82,fast learners
5663,19,31,14,64,42,slow leaners
5664,36,39,48,123,82,fast learners
5665,42,15,21,78,52,Average learners
5666,19,20,42,81,54,Average learners
5667,12,34,38,84,56,Average learners
5668,18,41,24,83,55,Average learners
5669,37,29,17,83,55,Average learners
5670,45,46,33,124,82,fast learners
5671,48,36,35,119,79,fast learners
5672,16,43,17,76,50,Average learners
5673,37,17,18,72,48,slow leaners
5674,25,48,21,94,62,Average learners
5675,23,16,39,78,52,Average learners
5676,35,27,36,98,65,Average learners
5677,45,30,43,118,78,fast learners
5678,24,28,34,86,57,Average learners
5679,31,35,47,113,75,fast learners
5680,44,30,16,90,60,Average learners
5681,20,44,11,75,50,Average learners
5682,20,29,12,61,40,slow leaners
5683,12,27,21,60,40,slow leaners
5684,45,22,32,99,66,Average learners
5685,11,28,20,59,39,slow leaners
5686,31,29,19,79,52,Average learners
5687,46,26,40,112,74,fast learners
5688,48,24,17,89,59,Average learners
5689,35,10,34,79,52,Average learners
5690,38,37,46,121,80,fast learners
5691,37,35,35,107,71,fast learners
5692,43,33,20,96,64,Average learners
5693,17,31,19,67,44,slow leaners
5694,45,11,15,71,47,slow leaners
5695,38,25,46,109,72,fast learners
5696,19,47,41,107,71,fast learners
5697,33,13,18,64,42,slow leaners
5698,47,45,35,127,84,fast learners
5699,18,37,46,101,67,Average learners
5700,12,20,11,43,28,slow leaners
5701,39,21,25,85,56,Average learners
5702,43,47,20,110,73,fast learners
5703,27,11,27,65,43,slow leaners
5704,33,40,13,86,57,Average learners
5705,19,29,21,69,46,slow leaners
5706,22,32,39,93,62,Average learners
5707,36,20,13,69,46,slow leaners
5708,48,24,25,97,64,Average learners
5709,32,23,30,85,56,Average learners
5710,46,34,35,115,76,fast learners
5711,13,22,29,64,42,slow leaners
5712,42,45,43,130,86,fast learners
5713,34,10,31,75,50,Average learners
5714,13,30,32,75,50,Average learners
5715,37,39,10,86,57,Average learners
5716,18,10,15,43,28,slow leaners
5717,31,47,11,89,59,Average learners
5718,18,34,36,88,58,Average learners
5719,43,49,25,117,78,fast learners
5720,45,44,41,130,86,fast learners
5721,14,49,44,107,71,fast learners
5722,11,43,36,90,60,Average learners
5723,36,43,11,90,60,Average learners
5724,42,38,32,112,74,fast learners
5725,38,34,44,116,77,fast learners
5726,39,24,22,85,56,Average learners
5727,24,19,31,74,49,slow leaners
5728,24,37,13,74,49,slow leaners
5729,13,12,28,53,35,slow leaners
5730,16,17,46,79,52,Average learners
5731,21,12,34,67,44,slow leaners
5732,16,21,41,78,52,Average learners
5733,34,38,30,102,68,Average learners
5734,28,14,39,81,54,Average learners
5735,43,45,49,137,91,fast learners
5736,44,39,26,109,72,fast learners
5737,22,48,43,113,75,fast learners
5738,37,34,46,117,78,fast learners
5739,22,17,48,87,58,Average learners
5740,31,46,32,109,72,fast learners
5741,46,30,28,104,69,Average learners
5742,26,47,16,89,59,Average learners
5743,20,22,27,69,46,slow leaners
5744,27,11,21,59,39,slow leaners
5745,17,33,47,97,64,Average learners
5746,21,32,37,90,60,Average learners
5747,25,31,20,76,50,Average learners
5748,22,35,33,90,60,Average learners
5749,25,38,47,110,73,fast learners
5750,39,22,43,104,69,Average learners
5751,44,15,10,69,46,slow leaners
5752,40,43,17,100,66,Average learners
5753,45,12,24,81,54,Average learners
5754,13,25,36,74,49,slow leaners
5755,42,23,20,85,56,Average learners
5756,12,18,35,65,43,slow leaners
5757,25,29,43,97,64,Average learners
5758,28,46,40,114,76,fast learners
5759,47,21,43,111,74,fast learners
5760,39,19,28,86,57,Average learners
5761,38,14,39,91,60,Average learners
5762,31,27,25,83,55,Average learners
5763,24,11,47,82,54,Average learners
5764,39,24,49,112,74,fast learners
5765,31,34,41,106,70,fast learners
5766,39,19,47,105,70,fast learners
5767,38,38,18,94,62,Average learners
5768,14,11,14,39,26,slow leaners
5769,35,31,14,80,53,Average learners
5770,29,46,20,95,63,Average learners
5771,40,34,15,89,59,Average learners
5772,28,15,46,89,59,Average learners
5773,26,41,12,79,52,Average learners
5774,25,31,41,97,64,Average learners
5775,37,39,31,107,71,fast learners
5776,12,21,14,47,31,slow leaners
5777,44,37,45,126,84,fast learners
5778,18,38,33,89,59,Average learners
5779,37,22,26,85,56,Average learners
5780,26,25,44,95,63,Average learners
5781,47,31,40,118,78,fast learners
5782,35,10,27,72,48,slow leaners
5783,32,37,25,94,62,Average learners
5784,17,43,35,95,63,Average learners
5785,40,47,26,113,75,fast learners
5786,49,34,10,93,62,Average learners
5787,16,44,48,108,72,fast learners
5788,37,43,41,121,80,fast learners
5789,49,10,48,107,71,fast learners
5790,11,37,41,89,59,Average learners
5791,26,28,15,69,46,slow leaners
5792,35,33,11,79,52,Average learners
5793,42,43,33,118,78,fast learners
5794,21,25,42,88,58,Average learners
5795,23,26,19,68,45,slow leaners
5796,47,17,43,107,71,fast learners
5797,34,12,40,86,57,Average learners
5798,25,31,18,74,49,slow leaners
5799,40,10,11,61,40,slow leaners
5800,27,32,32,91,60,Average learners
5801,20,20,36,76,50,Average learners
5802,14,47,34,95,63,Average learners
5803,15,16,18,49,32,slow leaners
5804,21,31,42,94,62,Average learners
5805,11,25,42,78,52,Average learners
5806,19,32,46,97,64,Average learners
5807,25,36,47,108,72,fast learners
5808,42,27,49,118,78,fast learners
5809,16,38,28,82,54,Average learners
5810,38,10,42,90,60,Average learners
5811,27,15,37,79,52,Average learners
5812,27,32,12,71,47,slow leaners
5813,45,19,39,103,68,Average learners
5814,22,33,26,81,54,Average learners
5815,34,33,35,102,68,Average learners
5816,40,39,45,124,82,fast learners
5817,29,36,16,81,54,Average learners
5818,12,13,36,61,40,slow leaners
5819,42,32,35,109,72,fast learners
5820,47,26,46,119,79,fast learners
5821,19,35,33,87,58,Average learners
5822,16,36,46,98,65,Average learners
5823,33,16,37,86,57,Average learners
5824,27,27,47,101,67,Average learners
5825,49,29,46,124,82,fast learners
5826,25,11,26,62,41,slow leaners
5827,44,15,10,69,46,slow leaners
5828,40,19,33,92,61,Average learners
5829,15,46,37,98,65,Average learners
5830,24,43,11,78,52,Average learners
5831,26,28,40,94,62,Average learners
5832,33,36,37,106,70,fast learners
5833,46,20,31,97,64,Average learners
5834,36,43,27,106,70,fast learners
5835,48,40,23,111,74,fast learners
5836,46,48,31,125,83,fast learners
5837,44,28,45,117,78,fast learners
5838,19,27,23,69,46,slow leaners
5839,45,11,23,79,52,Average learners
5840,48,37,11,96,64,Average learners
5841,34,43,35,112,74,fast learners
5842,48,40,32,120,80,fast learners
5843,11,38,23,72,48,slow leaners
5844,19,42,14,75,50,Average learners
5845,38,34,44,116,77,fast learners
5846,36,15,26,77,51,Average learners
5847,29,14,22,65,43,slow leaners
5848,27,26,34,87,58,Average learners
5849,46,22,18,86,57,Average learners
5850,32,49,23,104,69,Average learners
5851,39,23,21,83,55,Average learners
5852,29,29,22,80,53,Average learners
5853,13,32,47,92,61,Average learners
5854,23,48,26,97,64,Average learners
5855,32,22,25,79,52,Average learners
5856,25,24,15,64,42,slow leaners
5857,13,41,16,70,46,slow leaners
5858,27,41,42,110,73,fast learners
5859,49,39,14,102,68,Average learners
5860,29,17,17,63,42,slow leaners
5861,47,38,22,107,71,fast learners
5862,16,41,38,95,63,Average learners
5863,23,44,31,98,65,Average learners
5864,35,27,46,108,72,fast learners
5865,32,15,14,61,40,slow leaners
5866,44,44,32,120,80,fast learners
5867,48,11,12,71,47,slow leaners
5868,22,12,39,73,48,slow leaners
5869,46,11,16,73,48,slow leaners
5870,17,43,19,79,52,Average learners
5871,14,18,20,52,34,slow leaners
5872,27,35,14,76,50,Average learners
5873,34,48,44,126,84,fast learners
5874,39,12,44,95,63,Average learners
5875,14,22,42,78,52,Average learners
5876,17,12,22,51,34,slow leaners
5877,28,14,11,53,35,slow leaners
5878,39,42,19,100,66,Average learners
5879,14,10,21,45,30,slow leaners
5880,40,44,44,128,85,fast learners
5881,11,39,25,75,50,Average learners
5882,33,28,46,107,71,fast learners
5883,37,11,38,86,57,Average learners
5884,28,26,24,78,52,Average learners
5885,24,11,23,58,38,slow leaners
5886,17,28,18,63,42,slow leaners
5887,34,38,44,116,77,fast learners
5888,25,12,20,57,38,slow leaners
5889,13,48,28,89,59,Average learners
5890,31,36,42,109,72,fast learners
5891,47,39,36,122,81,fast learners
5892,31,21,43,95,63,Average learners
5893,23,31,27,81,54,Average learners
5894,43,10,25,78,52,Average learners
5895,31,49,33,113,75,fast learners
5896,43,31,21,95,63,Average learners
5897,24,43,37,104,69,Average learners
5898,27,11,18,56,37,slow leaners
5899,19,36,49,104,69,Average learners
5900,12,38,21,71,47,slow leaners
5901,23,35,49,107,71,fast learners
5902,29,24,40,93,62,Average learners
5903,32,28,36,96,64,Average learners
5904,14,25,28,67,44,slow leaners
5905,29,14,41,84,56,Average learners
5906,20,25,21,66,44,slow leaners
5907,26,33,34,93,62,Average learners
5908,23,19,22,64,42,slow leaners
5909,37,11,42,90,60,Average learners
5910,38,40,44,122,81,fast learners
5911,18,31,20,69,46,slow leaners
5912,40,36,14,90,60,Average learners
5913,34,19,37,90,60,Average learners
5914,13,43,13,69,46,slow leaners
5915,32,40,22,94,62,Average learners
5916,17,46,31,94,62,Average learners
5917,14,14,42,70,46,slow leaners
5918,13,24,19,56,37,slow leaners
5919,26,41,39,106,70,fast learners
5920,19,23,34,76,50,Average learners
5921,43,44,34,121,80,fast learners
5922,47,43,49,139,92,fast learners
5923,12,29,14,55,36,slow leaners
5924,42,42,42,126,84,fast learners
5925,11,10,23,44,29,slow leaners
5926,26,32,37,95,63,Average learners
5927,33,22,23,78,52,Average learners
5928,19,23,28,70,46,slow leaners
5929,49,12,35,96,64,Average learners
5930,18,40,18,76,50,Average learners
5931,43,29,35,107,71,fast learners
5932,45,30,17,92,61,Average learners
5933,24,32,36,92,61,Average learners
5934,24,12,40,76,50,Average learners
5935,27,33,28,88,58,Average learners
5936,26,45,14,85,56,Average learners
5937,15,45,28,88,58,Average learners
5938,43,34,37,114,76,fast learners
5939,17,46,26,89,59,Average learners
5940,13,19,12,44,29,slow leaners
5941,18,12,42,72,48,slow leaners
5942,15,14,22,51,34,slow leaners
5943,45,43,21,109,72,fast learners
5944,32,38,34,104,69,Average learners
5945,49,25,42,116,77,fast learners
5946,34,38,25,97,64,Average learners
5947,37,34,11,82,54,Average learners
5948,27,32,18,77,51,Average learners
5949,42,18,17,77,51,Average learners
5950,41,12,43,96,64,Average learners
5951,36,45,40,121,80,fast learners
5952,11,17,27,55,36,slow leaners
5953,41,21,48,110,73,fast learners
5954,39,24,35,98,65,Average learners
5955,31,31,24,86,57,Average learners
5956,35,25,20,80,53,Average learners
5957,27,42,16,85,56,Average learners
5958,17,47,27,91,60,Average learners
5959,44,17,48,109,72,fast learners
5960,11,33,26,70,46,slow leaners
5961,28,12,46,86,57,Average learners
5962,39,14,39,92,61,Average learners
5963,32,29,29,90,60,Average learners
5964,10,38,30,78,52,Average learners
5965,35,37,23,95,63,Average learners
5966,39,30,37,106,70,fast learners
5967,41,29,45,115,76,fast learners
5968,15,32,28,75,50,Average learners
5969,18,18,27,63,42,slow leaners
5970,10,44,32,86,57,Average learners
5971,35,48,40,123,82,fast learners
5972,16,19,37,72,48,slow leaners
5973,39,26,29,94,62,Average learners
5974,26,17,40,83,55,Average learners
5975,10,48,23,81,54,Average learners
5976,24,48,31,103,68,Average learners
5977,27,12,47,86,57,Average learners
5978,47,26,41,114,76,fast learners
5979,23,30,14,67,44,slow leaners
5980,15,41,47,103,68,Average learners
5981,25,31,17,73,48,slow leaners
5982,36,32,38,106,70,fast learners
5983,29,13,11,53,35,slow leaners
5984,28,18,28,74,49,slow leaners
5985,29,42,46,117,78,fast learners
5986,16,21,44,81,54,Average learners
5987,47,45,21,113,75,fast learners
5988,45,38,17,100,66,Average learners
5989,37,30,34,101,67,Average learners
5990,45,36,30,111,74,fast learners
5991,16,22,18,56,37,slow leaners
5992,16,28,23,67,44,slow leaners
5993,43,41,37,121,80,fast learners
5994,43,15,10,68,45,slow leaners
5995,16,22,20,58,38,slow leaners
5996,15,40,22,77,51,Average learners
5997,18,21,15,54,36,slow leaners
5998,21,20,29,70,46,slow leaners
5999,10,48,41,99,66,Average learners
6000,47,16,21,84,56,Average learners
